b|BELIEF/DOCTRINE/DOGMA|believing|(to be/have) faith/belief in doctrine|dogma/unquestionable belief
c|HEARING/SOUND|(to be) hearing of a sound|(to be) an inner ear|(to be) one’s aural faculty|(to be) listening (deliberate hearing)|(to be) using a listening device/instrument|(to be) an induced hearing experience
č|BE/EQUIVALENCE|(to be) ontologically the same entity|(to be) functionally equivalent|(to be) epistemologically synonymous
d|INANIMATE/MIXED REFERENT|3rd person inanimate|obviative|mixed animate+inanimate
ḍ|HERE (0/0/0)|position here|toward here|area around here
f|RIGHT (+X/0/0)|position right|rightward|right vicinity
g|AMBULATION|natural ambulation (walk, crawl)|rapid ambulation (run, gallop)|unnatural ambulation (limp, stagger)|formal ambulation (march, prance)|deliberate rapid ambulation (race, sprint)|deliberate unnatural ambulation (saunter, skulk)
j|TRANSFER OF POSSESSION/GIVE/RECEIVE|(to be) a transfer of possession|giving|receiving|formally transferring something|formally sending something|formally receiving something
k|BEHIND (0/-Y/0)|position behind|backward|vicinity behind
l|HUMAN BEING|adult human|human child|adolescent human
m|LINGUISTIC COMMUNICATION|(to be) a linguistic utterance for communication|(to be) a linguistic utterance for rhetorical/inspirational purposes|(to be) a phoneme/morphophonemic component of speech
n|ANIMATE REFERENT|1st person|2nd person|3rd person animate
ň|WRITE/INSCRIBE/DOCUMENT|(to be) something written (down), to write down|(to be) something authored in writing, to compose in writing|(to be) a written character/glyph/symbol used in writing|(to be) something documented, to document|(to be) a “page” of writing (as static medium)|(to be) a written symbol used in a language’s writing system
p|IN FRONT (0/+Y/0)|position in front|forward|vicinity ahead
r|NEGATION/NULLIFICATION/ABSENCE|negating something (making something not exist/apply)|denying something|being absent, an absence|nullifying or abrogating something|contradicting/contravening something|eliminating/removing something
ř|CONVENTIONALIZED TIME PERIOD|day (24-hour period)|week|month (lunar period)
s|[carrier root]|[formative from first Slot 7 affix]|[animate carrier]|[physical inanimate carrier]|[abstract carrier]|[full-stem concatenative adjunct]|[mixed animate/inanimate carrier]|[location carrier]|[complex abstract concept carrier]
š|SEX|biological sex|female|male
t|[demonstrative root]|this one (close to speaker)|that one (close to addressee)|that one (yonder) (close to neither speaker nor addressee)
ţ|POSITION/LOCATION/ORIENTATION/DIRECTION|(to be) the spatial position of an entity|direction relative to the observer|general vicinity of a location relative to the observer
v|LEFT (-X/0/0)|left position|leftward|left vicinity
x|SIZE/MEASURE/MEASURED DURATION|(to be/have) spatio-temporal size|(to be/have) spatial size|(to be/have) temporal "size"/duration
z|THREE/TRINARY|(to be) a set/group of 3 entities|(to be) something with 3 aspects/facets|(to be) the 3rd entity in a sequence
ẓ|SEE/SIGHT/VISION|sight, seeing something|(to be) an eye/organ of vision|(to be) one's visual faculty/sense|deliberately looking at something|using a visual-sensory device|creating/projecting a visual experience/image
ž|CAPACITY/ABILITY/CAPABILITY|physical capability/ability|physical stamina/fortitude/strength|physical prowess/finesse/specialized skill|consciously acquired physical capability/ability|consciously acquired physical stamina/fortitude/strength|consciously acquired physical prowess/finesse/specialized skill
bb[c]|EVEN/LEVEL (PARALLEL TO REFERENCE PLANE)|degree of evenness|decrease in evenness|increase in evenness
bc|FOURTEEN/14-ARY|(to be) a set/group of 14 entities|(to be) something with 14 aspects/facets|(to be) the 14th entity in a sequence
bč|MISTAKE/ERROR/MISCONCEPTION|being mistaken/wrong about something|having a misconception about something|misjudging/miscalculating something
bd|CONCAVITY/DEPRESSION|degree of concavity|decrease in concavity|increase in concavity
bḑ|CUCUMIS 1|European cantaloupe plant|North American cantaloupe plant|muskmelon
bf|GENERIC REPRODUCTIVE ORGANS/CELLS|gonad (testicle/ovary)|gamete (egg/sperm cell)|transport duct for gametes
bg|FULLNESS/EMPTINESS|degree of fullness|decrease in fullness|increase in fullness
bh|BAT|(micro)bat (Microchiroptera)|(mega)bat/fruit-bat  (Megachiroptera)|flying fox (genera Pteropus, Acerodon)
bj|BANG/BOOM/EXPLOSIVE SOUND|sound of banging (explosive sound)|sound of booming (low-pitched explosive sound)|sound of booming (high-pitched explosive sound)
bk|ORYZA|Asian rice grass (O. sativa)|African rice grass (O. glaberrima)|red rice/brownbeard rice grass (O. rufipogon)
bl|MOTION IN A CURVE
bn|CHANNEL/STEER/AIM|channeling (direct a course through a conduit)|steering (manually directing a course)|aiming (at/for something)
bn|CHANNEL/STEER/AIM|channeling (directing through a channel/conduit)|steering|aiming (for/at)
br|PERPENDICULAR-PLANAR TRANSLATIVE MOTION|lateral movement perpendicular to path/orientation|left-to-right movement relative to referent|right-to-left movement relative to referent
bř|IRRATIONALITY/MENTAL ILLNESS|state of irrationality|having a non-violent psychological disorder|state of violent/dangerous madness/insanity
bs|RELIGIOUS BELIEF/WORSHIP|(to be) holding a religious belief|(to be) a member of an organized religion|(to be) worshipping of a religious deity
bš|SOFT TEXTURE|soft like a cushion|downy texture|curvaceous/smooth/squeezable texture
bt|TRITICUM|common/bread wheat grass (T. aestivum)|durum/pasta wheat grass (T. durum)|spelt/dinkel wheat grass (T. spelta)
bţ|WET/MOIST TEXTURE|wet/liquidy|moist/damp|soggy/waterlogged
bv|WHITE|white|light-colored/pale-tinted|outshined by bright light/glare
bw|BODY OF SALT WATER|(to be) an ocean/sea|(to be) a lagoon|(to be) a saltwater pond/lake
bx|GENEROSITY/ALTRUISM/SELF-SACRIFICE|being generous, acting generously|being altruistic, acting altruistically|(to be) an act of self-abasement/self-abnegation
by|COMMON-SENSE/PRUDENCE/WISDOM|having common sense|being prudent/circumspect/discerning|being wise/sagacious based on analysis/introspection
bz|RABBIT/HARE/PIKA|rabbit/bunny/coney (Leproid)|hare/jackrabbit (genus Lepus)|pika (genus Ochotona)
bẓ|DEPTH|degree of depth|decrease in depth|increase in depth
bž|CETACEAN|baleen whale (Mysticeti)|toothed whale (Odontoceti)|dolphin/porpoise/narwhal (Odontoceti)
cb|MOTIVE/INTENTION|having a motive/basis for one's intention|having a purpose/intention/goal|having an incentive/stimulus|having a principle/ground/a basis|having an aspiration/"dream"|(to be) one's (free) will
cc|KIN/EXTENDED FAMILY RELATION|(to be) a member of a(n extended) family|(to be) a member of a(n extended) family (genetically or via marriage)|(to be) a member of a(n extended) family (via adoption)
cč|MODESTY/HUMBLENESS/MEEKNESS|being modest|being humble|being meek
cd|SPIRITUAL LOVE/EMOTION|feeling of love for existence|feeling of inherent "connection" to universe|feeling of being moved/humbled by something extraordinary
cḑ|ADHESION/STICKINESS/AGGREGATION|(to be) adhesion; to adhere|sticking (focus on textural stickiness)|aggregating/agglomerating (focus on new function)
cf|LEVELNESS/OVERALL FLATNESS|degree of overall flatness|decrease in overall flatness|increase in overall flatness
cg|PITY/MERCY/ALTRUISM|feeling pity|feeling mercy|feeling charitableness/altruism
ch|HEIGHT|degree of height|decrease in height|increase in height
cj|SMUGNESS/CONCEIT/FOPPISHNESS|(to be) conceited, full of oneself|(to be) smug, act smugly|(to be) prim/foppish/priggish
ck|PROXIMITY/DISTANCE|degree of proximity/distance|decrease in proximity/distance|increase in proximity/distance
cl|UNI-DIMENSIONAL CENTER PARALLEL TO LONG AXIS
cm|ARM|arm as supporting structure of entity|arm as appendage for holding, carrying|arm as functional "tool"/manipulator
cn|SUBSTANCE|(to be) a fundamental manifestation of a substance + substance itself|utilizing/working with a substance|(to be) the source of substance/compound
cň|PIN/TACK/STAPLE|(to be) a pin being used|(to be) a tack being used|(to be) a staple being used
cp|SIX/SEXIMAL|(to be) a set/group of 6 entities|(to be) something with 6 aspects/facets|(to be) the 6th entity in a sequence
cr|UNI-DIMENSIONAL MIDDLE (PERPENDICULAR TO LONG AXIS)
cř|GRIND/GRANULE/POWDER|grinding to gravel-like consistency|grinding to a granular consistency|grinding to a powder; pulverize
ct|INSPECT/EXAMINE/OBSERVE|looking something over (casual/brief observation)|examining something|inspecting something (verifying compliance to a standard)|observing something (understanding behaviour/purpose)|scrutinizing something|investigating something
cţ|2D SHAPELESSNESS|degree of 2D shapelessness|decrease in 2D shapelessness|increase in 2D shapelessness
cv|GRAY|gray|light gray|dark gray
cw|3D CENTER OF AN ENTITY
cx|MANNER/BEHAVIOR/METHOD/POLICY|(to be) the manner in which an entity acts/operates|(to be) the guise/form taken by an entity|(to be) one's behavior/conduct|(to be) the method by which an entity does something|(to be) the policy used by an entity in operating itself|(to be) one's bearing/demeanor
çb|TERRESTRIAL TOPOGRAPHY/LAND FEATURE/ARABILITY|(to be) a terrestrial land feature|(to be) an area of arable land|(to be) an area of non-arable land
çc|TRACK/TRACE/WAKE|(to be) a trail of passage left by entity|(to be) a 1/2/3-D wake or front left by passage of entity|(to be) a trail/wake left behind as demarcation/boundary
çd|IMPRESSION/APPEARANCE/GUISE|(to be) an impression, giving another an impression|(to be) the appearance/look/aspect of an entity|(to be) the guise of an entity
çf|CIVILITY/PEACEABLENESS|(to be) civil; act civilly|(to be) conciliation; acting conciliatorily|(to be) peaceable/peace-inspiring/non-violent
çg|CRUNCH/SLAM/CRASH|sound of crunching/scrunching/grinding|sound of slamming|sound of crashing
çk|ILLNESS/DISEASE/MALADY|(to have/to get sick with) an infectious illness/disease|(to be) a chronic physical malady/disorder (caused by environment/oneself)|(to be) a chronic physical malady/disorder (neoplastic/genetic/unknown origin)
çl|PREPARATION/PRECAUTION/READINESS|preparing for something (ensure ability to handle)|performing preliminary step for something else to occur|preparing/readying something (for consumption/use)|having/taking precaution|equiping, providing resources for something|instructing/training a party
çm|AFFECTIVE STATE|(to be in) a non-volitional/affective state|(to be in) a non-volitional/affective emotional state|(to be in) a non-volitional/affective physical/bodily state
çn|SOURCE/ORIGIN|(to be) the origin/source of something|(to be) a beginning/start point of something|(to be) a direct/primary cause|(to be) a basic element/starting point or principle|(to be) a fundamental reason/basis for something|(to be) a first/foundational principle, an axiom
çp|ACTION/MOVEMENT IN SITU|(to be/manifest) action/motion in-situ|move(ment) in-situ part of a larger whole|(to be) cyclic/oscillating in-situ movement
çţ|HISS/WIND HOWLING/WHISTLE|sound of hissing|sound of wind blowing/howling|sound of whistling
çr|SEPARATION/SEVERANCE/DETACHMENT|separating something from something else|detaching, physically disjoining/disconnecting|severing something
çř|HINDSIGHT|(to have) hindsight about something|discovering in hindsight that one missed an opportunity by fear|discovering in hindsight that a well-intentioned act backfired
çv|TRACTION/DRAWING/PULLING|pulling/drawing something (making it move by traction)|dragging/tugging something (with its resistance)|hauling/trawling something (using pulling to transport it)
çx|COFFEA|arabica coffee plant|robusta coffee plant (C. canephora)|unusual coffea plant
čb|DARE/AUDACITY/DAUNTLESSNESS|feel daring, like taking a risk|have the nerve to do something|feel dauntlessness, "devil-may-care"
čč|NAIVETE/FOOLISHNESS/IGNORANCE|(to be) naïve/foolish (failure due to bad analysis)|(to be) obtuse/"clueless" (failure to draw appropriate conclusions)|(to be) ignorant/unaware
čd|CHIRPING/SQUEAKING/TOOTING|sound of chirping|sound of squeaking/squealing|sound of tooting/hooting
čf|WIDTH/SLENDERNESS|degree of width|decrease in width|increase in width
čg|TEN QUADRILLION|(to be) a set/group of 100⁸ entities|(to be) something with 100⁸ aspects/facets|(to be) the 100⁸-th entity in a sequence
čh|DEGREE OF AFFECT (CUTENESS/GRANDEUR)|(to have) a degree of grandeur/greatness|(to have) a degree of elegance/loveliness|(to have) a degree of endearment/cuteness
čl|BETRAYAL/TREACHERY/INFIDELITY|breaking/betrayal one's promise/trust to/in someone|doing something devious/underhanded|going behind one's back, deceiving one's trust|(to be) an act of treachery|(to be) an act/instance of infidelity|(to be) an act of treason
čm|DEGREE OF EASE/DIFFICULTY|(to have) a degree of ease/difficulty (physical and mental effort)|(to have) a degree of ease/difficulty (effort in terms of practicality)|(to have) a degree of ease/difficulty (being faced with a dilemma)
čn|MOVE APART/DRAW APART/OPEN|moving two entities apart, creating a gap|pushing an entity in order to create a gap|pulling an entity in order to create a gap
čň|COCKROACH|Oriental/American/Australian/brown/common cockroach  (Blattoid)|Asian/European/German cockroach (Blaberoid)|sand/cave cockroach  (Corydioid)
čp|STUPIDITY/SHALLOWNESS|(to be) stupid/dumb/simple-minded|(to be) non-intellectual/non-conceptual in one's thinking|(to be) shallow/anti-intellectual
čr|HOSTILITY/AGGRESSION|(to be) verbal abuse; attack someone verbally|(to be) passive-aggressive towards someone|(to be) physically hostile/aggressive towards someone
čř|BODILY WASTE ELIMINATION|feel the need to pee/piss (CPT=urinate)|feel the need to poop/shit (CPT=defecate)|feel the need to spit (CPT=spit)
čt|PROCYONINE|raccoon (genus Procyon)|coati (genera Nasua, Nasuella)|ringtail cat, cacomistle (genus Bassariscus)
čv|TRANSPORT STOP/PORT/HUB|stopping on a transport route|(to be) a transport station|(to be) a harbor, place of anchorage|(to be) a location served by a sea/air line|(to be) a transport terminal|(to be) a port or transportation hub
čw|GREEN|green|chartreuse|sea green, teal green
čx|IRRATIONALITY/HYSTERIA/PARANOIA|(to be) irrational, act irrationally|(to be) hysterical, impervious to serenity|(to be) paranoid
db|SOLIDITY/PERMEABILITY|degree of solidity|decrease in solidity|increase in solidity
dd|PERPENDICULAR/UPRIGHT (RELATIVE TO GRAVITY)|degree of perpendicularity|decrease in perpendicularity|increase in perpendicularity
df|BUMPY TEXTURE|bumpy, discernable bumps on quasi-linear/planar surface|stucco-like, small bumps only discernible through inspection|pitted/serrated
dg|WEIGHT/MASS|degree of weight|decrease in weight|increase in weight
dh|DEGREE OF DIRECTNESS/FRANKNESS/OBVIOUSNESS|(to be) direct/blunt/frank (easy to understand)|(to be) obvious/blatant (impossible not to notice)|(to be) straightforward/simple
dk|LINEAR POSITION BETWEEN|position amidst one dimension|toward a position in one dimension|vicinity of a position in one dimension
dl|VERTICAL-PLANAR RANGE OF MOTION (random motion within)
dn|NAME/DESIGNATION/TITLE|(to be) a name; to be named something|(to be) a designation/reference; to be referred to as|(to be) a label|(to be) a title|(to be) a formal designation|(to be) a role
dň|COMMERCIAL ENTERPRISE/BUSINESS/INDUSTRY|(to be) conducting business as a commercial enterprise|(to be) making a commercial product available for purchase|(to be) an industrial enterprise
dp|KNOCK/THUMP/SMACK|sound of knocking|sound of thumping (light, between semi-solid objects)|sound of smacking (forceful, between semi-solid objects)
dr|HORIZONTAL PLANAR TRANSLATIVE MOTION
dř|TOOTH|tooth|fang|tusk
dv|EXCHANGE/PURCHASE/BUY/SELL|exchanging/swapping|taking something offered in exchange for something else|giving away something in exchange for something else|(to be) a commercial exchange, buying/selling|purchasing/buying|selling/vending
dw|BOTTOM/FOUNDATION OF AN ENTITY
dx|HEDGEHOG|common hedgehog (genus Erinaceus)|African hedgehog (genus Atelerix)|Asian hedgehog (genera Hemiechinus, Mesechinus, Paraechinus)
dy|TOP/PEAK/SUMMIT OF AN ENTITY
ḑb|SEPARABLE POSITION AMIDST 3D|position separable from 3D midst|toward a position separable from 3D midst|vicinity of a position separable from 3D midst
ḑc|SAFETY/SECURITY/LOCK|making something safe|securing/safekeeping something (protect from external threats)|locking something (prevent external access)
ḑč|BLACK-OUT/SPELL/SEIZURE|"blanking out"/"blacking out"|"zoning out"/"spacing out"|experience a seizure
ḑd|SEPARABLE POSITION AMIDST 2D|position separable from 2D midst|toward a position separable from 2D midst|vicinity of a position separable from 2D midst
ḑḑ|SLEEP/UNCONSCIOUSNESS/COMA|(to be) asleep, putting to sleep|(to be) unconscious, to be/make unconscious|(to be) in a coma, to be/put in a coma
ḑf|GOVERNMENT|(to be) governance; to govern|(to be) political|(to be) a group of authorities recognized as a government
ḑg|INTEGRATED POSITION AMIDST 3D|position integrated in 3D midst|toward a position integrated in 3D midst|vicinity of a position integrated in 3D midst
ḑj|ERECT/LET RISE UP/RAISE UP|erecting something perpendicular to the ground|letting something rise up to an erect position|raising something to a higher level
ḑk|MENTAL IMAGE/IMAGINATION/CREATIVITY|(to be) a mental representation|(to be) imagination, imagining|(to be) creative
ḑl|CARDIO-PULMONARY ORGANS|heart|lung|diaphragm
ḑļ|WAXY/OILY TEXTURE|oily texture|waxy texture|greasy lard-like texture
ḑm|BLUFF/TRICK/DISGUISE|bluffing/misleading/feinting|tricking|disguising|deceiving|cheating|swindling/chicanery
ḑn|LYING/DISHONESTY/PERJURY|lying/stating a falsehood|being dishonest/disingenuous|(to be) perjury
ḑň|CHEESE
ḑp|LARGE DECAPODIAN CRUSTACEAN|lobster/crayfish|crab|shrimp/prawn
ḑr|CYAN|cyan|greenish cyan|bluish cyan
ḑř|STRETCH/ELONGATE/SPREAD|1D stretching/elongating|2D stretching/spreading|3D stretching/expanding
ḑv|INTEGRATED POSITION AMIDST 2D|position integrated in 2D midst|toward a position integrated in 2D midst|vicinity of a position integrated in 2D midst
ḑw|LOWER PART/“HALF” OF AN ENTITY
ḑx|VOICE/VOCAL UTTERANCE|making a sound vocally, vocalizing (bark, meow,...)|making the usual sound made by entity|making a less common sound made by an entity
ḑy|UPPER PART/“HALF” OF AN ENTITY
fb|ARTICLE OF CLOTHING|(to be) clothing worn for body covering|(to be) clothing worn as fashion statement|(to be) clothing worn as ornament/accessory|(to be) clothing worn as a uniform|(to be) clothing worn as a costume|(to be) an ornament/accessory worn as indicator of rank/award/status
fc|3-DIMENSIONAL VOLUME|degree of 3D volume|decrease in 3D volume|increase in 3D volume
fç|DESCRIPTION/ACCOUNT/REPORT|describing something|giving an account of/relating/recounting an event|communicating one’s thoughts/observations|delineating/giving specific details|narrating/telling a story|reporting something
fč|EXCLUDE/BANISHMENT/OSTRACIZATION|excluding an entity from something|expulsion/ejecting an entity|banishing an entity|sequestering/segregating an entity|deporting/expatriating an entity|exiling an entity
fd|TABLE SALT (SODIUM CHLORIDE)
ff|PSYCHOLOGICAL PLEASURE|feel psychological/emotional pleasure|feel psychological relief|feel psychological sense of satisfaction
fg|HAIRY/FURRY TEXTURE|hairy texture|soft furry/feathery texture|woolly texture
fh|FIND/ENCOUNTER/MEET|finding/discovering something (by chance)|encountering/coming across something (by chance)|meeting someone (by chance)
fj|IMPEDE/BLOCK/INTERFERE|impeding/hindering the path/flow of an entity|placing an obstacle/impediment, clogging|interfering/obstructing some entity/activity/state|constricting/choking something|sealing/plugging something|preventing something from happening
fk|RIGHT+BEHIND (+X/-Y/0)|position right & behind|rightward & backward|area right & behind
fl|MOTION IN A PLANAR CIRCULAR PATH
fļ|POMPOSITY/BOASTING/ONE-UPMANSHIP|(to be) pompous/pretentious|bragging/boasting about something|one-upping someone|(to be) vainglorious|(to be) megalomaniacal|(to be) self-aggrandizing
fm|DEGREE OF VELOCITY|(to have) a degree of speed|(to be) accelerating|(to be) decelerating
fn|HUNGER/THIRST|feel hungry|feel thirsty|feel undernourished
fň|NON-PLANT WATERLIFE FORM|motile/free-swimming waterlife form|crawling waterlife form|non-motile/sessile waterlife form
fp|RIGHT+FRONT (+X/+Y/0)|position right & in front|rightward & forward|area right & ahead
fr|PARALLEL TRANSLATIVE MOTION
fř|SHAPE/FORM/MOLD|(to be) a 2D shape or outline form|(to be) a 3D shape/form|(to be) a figure based on shape/form|(to be) a 2D contour/outline as a representation/model|(to be) a 3D contour/outline as a representation/model|(to be) a mold/pattern/cast
fs|WAITING/EXPECTATION/READINESS|anticipating/expecting/awaiting something|readiness/preparedness for an expected event|readiness/preparedness in case of an unexpected event
fš|FITTING/ACCOMMODATION/NICHE|an entity physically fitting with another as to be carried|accommodating something|finding/establishing a niche for something
ft|TOUCH/FEEL/TEXTURE|(to be) a tactile sensation/texture and the act of touching|(to be) one's tactile organs|(to be) the sense of touch|(to be) a deliberate tactile examination|(to be) utilizing a tactile-like sensory instrument|(to be) an induced tactile experience
fţ|DEGREE OF EFFICIENCY/ADEQUACY|(to be) a degree of efficiency|(to be) a degree of adequacy|(to be) a degree of reward/payoff
fw|RIGHT+BELOW (+X/0/-Z)|position right & below|rightward & downward|area right & below
fx|AVOID/SHUN/ESCHEW|avoiding, staying away from|shunning|eschewing/abstaining from something|boycotting/embargo|ostracizing|rejecting
fx|DEGREE OF CONFIDENCE/HUMILITY|(to have) a degree of confidence|(to have) a degree of humility|(to have) a degree of authoritativeness
fy|RIGHT+ABOVE (+X/0/+Z)|position right & above|rightward & upward|area right & above
fz|VISCOUS/GOOEY TEXTURE|viscous/gooey texture|jelly-like texture|sticky texture
gb|COMPRESSION/SQUEEZEDNESS|degree of compression|decrease in compression|increase in compression
gc|SOLID BUT MALLEABLE TEXTURE|solid but malleable texture|plastic-like texture|cartilaginous texture
gč|MALE REPRODUCTIVE ORGANS|penis|glans of penis|scrotum
gd|CONVEXITY/ROTUNDITY|degree of convexity|decrease in convexity|increase in convexity
gḑ|PHYSICAL SENSE OF WELL-BEING|feel good, sense of well-being|feel relaxed|feel post-orgasmic/coital bliss
gf|HOLD TOGETHER/BIND/HOLD STILL|holding something together on the long term|binding something|restraining, holding something still
gg|STRAIGHTNESS/LINEARITY (INTRINSIC)|degree of straightness|decrease in straightness|increase in straightness
gh|BRUISE/SWELLING/INFLAMMATION|have/feel a bruise|feel sore, inflammation, swelling|have a sensitive/tender feeling on the body
gj|ROUNDEDNESS|degree of roundedness|decrease in roundedness|increase in roundedness
gl|HORIZONTAL-PLANAR RANGE OF MOTION (random motion within)
gm|ELEPHANT/MAMMOTH|African elephant (genus Loxodonta)|Asian elephant (genus Elephas)|mammoth (genus Mammuthus)
gn|ORIGIN/BEGINNING/CAUSE|(to be) origination; to originate|(to be) beginning, initiating, starting|(to be) causation; to cause (primary/direct)
gp|CLAP/SNAP/CRACK|sound of clapping/slapping|sound of snapping|sound of cracking
gr|OBLIQUE LATERAL TRANSLATIVE MOTION
gř|BONE|quasi-cylindrical bone|plate-like bone|special-shaped bone (e.g., rib)
gs|CHUNKY/GRITTY TEXTURE|chunky texture|gravel-like texture|coarse sand-like texture
gš|LOSE/SQUANDER/FORFEITURE|something being lost (misplaced)|losing something/someone (potentially unrecoverable)|squandering/wasting something|being deprived of something|being bereaved|forfeiting something
gt|OVERSIGHT/RESPONSIBILITY/REGULATION|overseeing something/someone|being responsible for something/someone|(to be) oversight/governance to maintain one's responsibility|being in charge of something|supervising something|regulating something
gţ|TIGHTNESS/FITTEDNESS/COMPATIBILITY|being tight, difficult to disjoin|(to be) one entity physically fitting with another|(to be) an entity potentially functioning better along with another
gv|DESIRE/WANT|(to be/have) an affective state of want/desire|(to be/have) wish/hope for something|(to be/have) an aspiration|(to be/have) a request for something|(to be/have) a preference for something|(to be/have) a demand for something
gw|BODILY ORGAN/GLAND/TISSUE|bodily organ|gland|tissue (non-organ, non-gland)
gy|RED|red|crimson|salmon (color)
gz|ONE HUNDRED/CENTESIMAL|(to be) a set/group of 100 entities|(to be) something with 100 aspects/facets|(to be) the 100th entity in a sequence
gẓ|TEMPORAL INTERVAL|degree of elapsed time|decrease in elapsed time|increase in elapsed time
gž|FLINCH/JOLT/DUCK|flinct/jolt|duck/crouch (as reflex)|jump/leap out of the way (as reflex)
jb|2D DECORATIVE PATTERN/TEXTURE|(to be) a simple 2D design/pattern|(to be) a complex 2D design/pattern|(to be) a 2D texture
jd|MALICE/CRUELTY/SADISM|feel mean/malicious/ill-willed|feel cruel/sadistic|feel sadistic pleasure at someone’s pain
jḑ|PREDICAMENT/CRISIS/DILEMMA|being in/facing a predicament|being in/facing a crisis|being in/facing a dilemma
jf|INDECISIVENESS/FICKLENESS/UNRELIABILITY|(to be) indecisive|(to be) fickle|(to be) unreliable
jg|DIMENSIONAL ATTRIBUTE|degree of a dimensional attribute|decrease in a dimensional attribute|increase in a dimensional attribute
jh|DEGREE OF PHYSICAL CONTROL|(to be) a degree of physical control|(to be) a degree of physical dexterity/finesse|(to be) a degree of control by potential force
jj|DIG/HOLE|digging|removing material via digging|leaving behind a concavity via digging
jk|BRAVERY/FEARLESSNESS|feel willingness to take a risk|feel brave, fearless|feel intrepid, courageous
jl|MOUNTAINOUS TOPOGRAPHY|(to be) elevated land, a hill/mountain|(to be) a peak, single elevated upwelling|(to be) a plateau/butte/mesa
jļ|SPATIAL GAP|degree of spatial gap|decrease in spatial gap|increase in spatial gap
jm|DEGREE OF OPEN-MINDEDNESS/BIGOTRY|(to be) a degree of open-mindedness|being able to see the world from a relative perspective|(to be) a degree of bigotry
jn|LENGTH|degree of length|decrease in length|increase in length
jň|OPPOSITION/FIGHTING/DEFIANCE|being opposed to something/someone|working against something/someone|fighting, being violent towards something/someone|being antithetical towards something/someone|defying/disobeying something/someone|being at war/enemies with someone
jp|PHASEOLUS VULGARIS (COMMON BEAN) 1|kidney/red bean plant|white/navy bean plant|cannellini bean plant
jr|RIDE/DRIVE/TRANSPORT|riding/driving (operating a mechanical device)|being a passenger transported/conveyed|transporting via means of transportation
jř|GASTRO-INTESTINAL PAROXYSM 1|feel need to burp (CPT=burp)|experience a hiccup|experience gagging
jt|FAMILIARITY/CUSTOM/TRADITION|(to be) something familiar|(to be) something customary|(to be) something traditional
jţ|PENETRATION/DRIVING INTO/INJECTION|penetrating through a 2D surface|(forcefully) driving into a 2D surface|injecting
jv|COOPERATION/TEAM/COLLUSION|cooperating|forming a team, teaming up with|colluding|collaborating|allying with|conspiring
jw|LAUGHTER|laugh|snicker|chuckle
jx|GRATED TEXTURE|2D grated texture|3D grated texture|malleable grated texture
kb|ASSOCIATION/DEALING WITH/RELATION TO/ENGAGEMENT WITH|dealing with|pertaining to|becoming involved with
kc|PLANT PART 1|seed/pit of a plant|fruit/nut of a plant |bulb/tuber of a plant
kç|CUT/STAB/CRACK|cutting something with a blade/force|stabbing something|making a crack/rent in something
kč|OUTWARD REACH|degree of reach|decrease in reach|increase in reach
kd|HARD/RIGID TEXTURE|hard/rigid|hard/rigid and naturally smooth|hard/rigid and naturally rough
kḑ|CAUSTIC/BURNING SENSATION|burning sensation|caustic/corrosive sensation|irritating sensation
kf|REAR/BACK PART OF AN ENTITY
kh|DEGREE OF NUANCE/CUNNING/STEALTH|(to be) a degree of nuance/subtlety|(to be) a degree of cunning/guile|(to be) a degree of stealth
kj|”TOUGHNESS”/RESILIENCY|(to be) “tough”/perseverant|(to be) personally resilient|(to be) “antifragile”, i.e learning from a hardship
kk|LINEAR POSITION BETWEEN*|position amidst one dimension|toward a position in one dimension|vicinity of a position in one dimension
kl|PERPENDICULAR-PLANAR RANGE OF MOTION
km|PUNCTUALITY/EARLINESS/LATENESS|(to be) a degree of punctuality|(to be) something early|(to be) something late
kn|DESERVE/WORTHINESS/REWARD|(to be) deserving of something|(to be) worthy, to merit|(to be) granting a party what they deserve|(to be) entitlement|(to be) loyal|(to be) formally rewarding someone
kp|DEGREE OF EFFORT|(to be) a degree of effort|(to be) a degree of (mental/intellectual) effort|(to be) a degree of effort (organizational complexity)
kr|OBLIQUE VERTICAL QUASI-LINEAR MOTION|ascending descending at a slant|oblique ascent|oblique descent
kř|FEEL ILL/SICK|feel ill/sick/unhealthy|feel torpor/lethargy|feel weakness
ks|TWO/BINARY|(to be) a set/group of 2 entities|(to be) something with 2 aspects/facets|(to be) the 2nd entity in a sequence
kš|BUFFOONERY/ABSURDITY/SURREALISM|(to be) buffoonish/silly|(to be) absurdist/”dada-esque”|(to be) eccentric/surreal|(to be) performing as a clown|(to be) absurdist/dad-esque art|(to be) surrealist art
kt|PAST/PRESENT/FUTURE|(to be) a past event/occurrence/entity|(to be) a present event/occurrence/entity|(to be) a future event/occurrence/entity
kţ|DEVELOPMENT/MATURATION/DECLINE|(to be) the developmental stage of a life cycle|(to be) the maturation stage of a life cycle|(to be) the declining stage of a life cycle
kw|BEHIND+BELOW (0/-Y/-Z)|position behind & below|backward & downward|area behind & below
ky|BEHIND+ABOVE (0/-Y/+Z)|position behind & above|backward & upward|area behind & above
kẓ|ONE HUNDRED MILLION|(to be) a set/group of 100⁴ entities|(to be) something with 100⁴ aspects/facets|(to be) the 100⁴-th entity in a sequence
lb|STABILITY/INSTABILITY|degree of stability|decrease in stability|increase in stability
lc|PATHWAY/ROADWAY/CHANNEL|(to be) a marked pathway/trail|(to be) a marked roadway/route/street|(to be) a marked conduit-like channel
lç|GUESS/SUPPOSITION/ASSUMPTION|guessing/speculating|supposing (consider as possibility)|assuming/presuming (considering correct in lack of evidence)|postulating/making a conjecture|theorizing|hypothesizing
lč|PSYCHO-SOCIAL IDENTITY|(to be) one’s psychological identity|realizing that one’s psychological identity is changing/surfacing|transitioning to a particular psychological identity
ld|VOLATILITY/INERTNESS|degree of volatility|decrease in volatility|increase in volatility
lḑ|TREE/SHRUB/BUSH|tree|shrub|bush
lf|DEGREE OF LUCK/CHANCE/PROBABILITY|(to be) a degree of luck (unpredictable outcome of predictable input)|(to be) a degree of chance (unpredictable outcome of unpredictable input)|(to be) a degree of probability
lg|DURATION/TEMPORARINESS|degree of duration|decrease in duration|increase in duration
lh|COLLATERAL FAMILIAR RELATION|(to be) a parent’s sibling|(to be) a sibling’s child|(to be) a parent’s sibling’s child
lj|GOLD|gold|Au ion w/missing electron(s)|Au ion w/additional electron(s)
lk|MUSIC/PLAY MUSIC/COMPOSE MUSIC|(to be) music playing|playing/making music|composing a piece of music
ll|ONE/UNITY|(to be) a set/group of one|(to be) something indivisible/unified|(to be) the first entity in a sequence
lļ|ACKNOWLEDGMENT/REVELATION/ADMISSION|acknowledging something|disclosing/revealing something|admitting/conceding something|assenting/acquiescing|divulging/exposing something|confessing something
lm|DEGREE OF BODILY STRENGTH/ENERGY/STAMINA|(to be) a degree of brute bodily strength|(to be) a degree of bodily energy/vigor|(to be) a degree of stamina
ln|TIME OF DAY|(to be) daytime|(to be) nighttime|(to be) an o’clock time
lň|TAIL/CAUDAL STRUCTURE|tail|flagellum|tail-like body part
lp|PRIDE FOR ANOTHER/RESPECT/ADMIRATION|being proud for a party|having respect for a party|having admiration for a party
lr|WING|wing (avian/feathered)|wing (mammalian/reptilian)|wing-like extension for flying (e.g., plane)
lř|FLATTEN/SMOOTH/LEVEL|flattening something|making something smooth|making something (more) level/even/parallel
ls|AMIABILITY/VIVACIOUSNESS/BOISTEROUSNESS|(to be) friendly/amiable|(to be) vivacious|(to be) larger-than-life/boisterous
lš|EXALTATION/ECSTASY|feel exaltation, “on top of the world”|feel ecstatic joy and wonder from being alive|feel one’s life-state as perfect, “it doesn’t get any better”
lt|AUTOCRAT ↔ SUBJECT|(to be) a ruler’s autocracy and a subject’s submission|ruling as an autocrat|submitting to an autocrat as a subject
lţ|SKIN/BARK/PEEL|skin/hide/pellicle|bark/integument of plant|peel/rind/husk
lv|CERVINE|deer|elk/wapiti|hog deer/fallow deer/chital/swamp deer/thamin
lw|BLUE|blue|azure/royal blue|indigo
lx|NON-PLANETARY ASTRAL BODY|(to be) a star/stellar body|(to be) a comet|(to be) a small asteroid|(to be) the Sun/Sol|(to be) a named comet|(to be) a named small asteroid
ly|VISUAL DESIGN/ARTISTIC REPRESENTATION|creating a visual design manually|producing a 2D visual image/representation|crafting a 3D visual representation/model|creating a visual design for aesthetic purposes|creating a work of visual art|creating a work of sculpture
lz|BODY OF FRESH WATER|(to be) a pond/lake|(to be) a stream/river|(to be) a freshwater inland sea
lẓ|NINE/NONARY|(to be) a set/group of 9 entities|(to be) something with 9 aspects/facets|(to be) the 9th entity in a sequence
lž|FACE/VISAGE|face (as surface + attached organs/parts)|face (as an interface for vocalizing and emoting)|face/visage (as means of identification/recognition)
ļb|FIZZING/BUBBLING/SPLASHING|sound of fizzing|sound of bubbling/boiling/gurgling|sound of splashingerestere
ļc|CURIOSITY/INTEREST|feel curiosity|feel interest|feel intrigued
ļf|WAKEFULNESS|(to be) awake, fully conscious|(to be) waking (up), regaining consciousness|(to be) dozing or half-awake
ļj|THIRTEEN/TRIDECIMAL|(to be) a set/group of 13 entities|(to be) something with 13 aspects/facets|(to be) the 13th entity in a sequence
ļk|SALTY/SPICY/UMAMI|salty flavour|spicy/piquant flavor|umami/savory flavor
ļl|VISIT|visiting someone socially|visiting a place, sightseeing|visiting formally
ļm|FEEL TIREDNESS/FATIGUE|feel tiredness/fatigue|feel drowsiness/sleepiness|feel unfocused/groggy
ļn|VALUE/OPPORTUNITY/SUITABILITY|(to be) something potentially worthwhile/of value|(to be) something expedient/opportune|(to be) something suitable/fitting/apropos|(to be) something advantageous/favorable|(to be) an opportunity/chance to do something normally unavailable|(to be) something convenient
ļň|PSYCHE/MIND|(to be) one’s psyche (conscious+unconscious mind)|(to be) one’s conscious mind|(to be) one’s unconscious mind
ļr|BALANCE/EQUILIBRIUM/SYMMETRY|(to be) balanced/in balance|(to be) equilibrium|(to be) entities being in proper proportion to one another|(to be) symmetrical|(to be) in parity|(to be) in homeostasis
ļř|INSTINCT|(act on) instinct|involuntary reflex|autonomic reflex
ļt|TICKING/CLICKING/TAPPING|sound of ticking|sound of clicking|sound of tapping
ļv|WISPY/FLUFFY TEXTURE|wispy/wafting/misty texture|fluffy/puffy/cottony texture|cobwebby/cotton-candy texture
ļw|ABNORMAL INTEROCEPTIVE SENSATION|feel light-headed/dizzy|feel faint|feel shock/be in shock
ļy|WITNESSING|witnessing something|witnessing something one didn’t wish to|witnessing something inappropriate/taboo
mb|ABSORPTIVITY|degree of absorptivity|decrease in absorptivity|increase in absorptivity
mc|JUNCTION/CONNECTION/FASTENING|joining multiple entities to form a set|physically connecting multiple entities together|fastening/bonding multiple entities physically|linking multiple entities together (focus on preserved individuality)|unifying/uniting multiple entities (subjectively into one entity)|fusing/merging/coalescing multiple entities (making them indivisible, without individuality)
mç|WELL-FORMEDNESS/AESTHETIC APPEAL/STYLISHNESS|(to be) well-formed/shapely|(to be) aesthetically/sensually pleasing/appealing|(to be) stylish/decorative/ornamental|(to be) perfect (cannot be better)|(to be) exquisite/superb/sublime|(to be) ornate/splendid
mč|POWER/EFFICACY/POTENCY|(to be) powerful (strong force derived from energy)|(to be) efficacious (able to do things effectively)|(to be) potent/powerful|(to be) forceful, have force (directed use of energy)|(to be) productive|(to be) effective
md|REFLECTIVITY|degree of reflectivity|decrease in reflectivity|increase in reflectivity
mḑ|BODILY HAIR/FUR/FEATHER|one human bodily hair|one non-human bodily hair|a feather
mf|APPRECIATION/HONORING/VENERATION|appreciating/commending a party|honoring upon someone|venerating/revering a party
mg|TRANSPARENCY/OPACITY|degree of transparency|decrease in transparency|increase in transparency
mh|DEGREE OF CHANGE/STABILITY/FLUCTUATION|(to be) a degree of change/mutability/constancy|(to be) a degree of stability/vicissitude|(to be) a degree of fluctuation/wavering/variance
mj|FELL/BRING DOWN/LOWER|making something fall via gravity, felling|letting something fall, dropping|lowering something down to the ground
mk|IMITATION/MIMICRY/MAKEBELIEVE|imitating|mimicking/feigning|pretending/make-believing|simulating|impersonating|acting a (dramatic) role
ml|YELLOW|yellow|gold (color)|lime (color)
mļ|OBSCURITY/AMBIGUITY/STEALTH|obscuring, rendering something obscure/unclear|obfuscating/rendering something ambiguous|(to be) stealthy/surreptitious
mm|MEMBER OF PARENT-OFFSPRING RELATION|(to be) a biological parent/progenitor|(to be) a biological child|(to be) a biological grandparent
mn|MOOD/TEMPERAMENT/NATURE|mood|one’s natural/usual demeanor|one’s sense of self and place in the world
mň|SCREECH/GROWL/ROAR|sound of whining/screeching/shrieking|sound of defensive animal (growling,hissing)|loud vocalization of animal (roar, bark, neigh)
mp|NUCLEAR FAMILY MEMBER|(to be) a parent|(to be) a child|(to be) a grandparent
mr|DEATH|dying|approaching death, being dying|being mortal
mř|SUMMER|(to be) summer/summertime|(to be) the peak state of flora due to summer|(to be) the summer solstice
ms|SWEET FLAVOR|sweet flavor|fruity/citrus flavor|floral-like sweet flavor
mš|COURAGE/BRAVERY/VALOR|(to be) brave (undaunted by danger)|(to be) courageous/intrepid|(to be) valourous/gallant/bold
mt|AGE/LIFE-STAGE/PHASE|(to be) aging|(to be) a (developmental) stage/phase in life|(to be) a birthday celebration
mţ|DEGREE OF PUBLICITY/PRIVACY/AVAILABILITY|(to have) a degree of publicity/notoriety vs secrecy|(to have) a degree of privacy/concealment|(to have) a degree of diffusion/availability
mv|CATTLE|cow/bull/cattle/auroch|gaur/gayal/banteng|yak/kouprey
mw|SMILE/GRIN/SMIRK|smile (lips closed)|grin (teeth visible)|smirk
mx|APOSTASY/HERESY/ICONOCLASM|(to be) apostatic, losing one’s faith/belief|(to be) heretical|(to be) iconoclastic
my|GRATITUDE/THANKFULNESS/PRAISE|offering gratitude for a favor/honor/courtesy performed|offering gratitude for being saved from an adverse situation|offering gratitude merely as a superficial courtesy
mz|REMEMBER/MEMORY/VESTIGE|(to be) a memory|(to be) retention of something past into the present|(to be) memorization|trace/track/vestige|memorial|recording, a record
mẓ|COPPER|copper|Cu ion w/missing electron(s)|Cu ion w/additional electron(s)
mž|SEXUAL/ROMANTIC RELATIONSHIP|(to be) a sexual/romantic relationship between parties|(to be) sexual relations, sex|(to be) pursuing a sexual/romantic relationship, dating/courting
nç|GOAT-LIKE ANIMAL|domestic goat|ibex|wild goat
nd|QUESTION/ANSWER/INQUIRY|(to be) question & answer|(to be) questioning/querying|(to be) answering/responding|inquiry/investigation + resulting discovery|inquiry/investigation|discovery/finding (via investigation)
nḑ|HUMAN-SPECIFIC HAIR|one human head hair|one human facial hair|one human armpit/pubic/eyebrow hair (thick but fixed length)
nf|PARTNERSHIP/UNION/MARRIAGE|(to be) partnering, a partner with/to another|(to be) in league with another, one’s fellow-X/co-X|(to be) engaged/promised/betrothed to another|(to be) a colleague to another|(to be) united, in union with another|(to be) married/wedded to/with another
ng|PRESSURE|degree of pressure|decrease in pressure|increase in pressure
nh|DEGREE OF PROXIMITY/DISTANCE|(to be) a degree of linear spatiotemporal proximity|(to be) a degree of linear spatial proximity|(to be) a degree of temporal proximity/distance
nk|BODILY DIGIT|finger|thumb|toe
nl|HAND|hand as fine manipulatory body part|hand as holder/grasper/striker|hand as primary tactile-sensory interface
nļ|CITRUS HYBRID 1|sweet orange|bitter orange|key lime
nm|FEMALE REPRODUCTIVE ORGANS|uterus/womb|cervix|vagina
nn|HELP/ASSISTANCE/SUPPORT|aiding/helping|assisting/lending a hand|supporting/advocating|serving/tending to|patronizing|subsidizing
nr|FOOT/PAW|foot/paw as primary contact with the ground|foot/paw as ambulatory appendage|foot/paw as functional manipulator (kicking, pushing)
nř|ENTHUSIASM|feel enthusiasm|feel enthusiastic anticipation|feel lucky/auspicious/propitious
ns|SEVEN/SEPTENARY|(to be) a set/group of 7 entities|(to be) something with 7 aspects/facets|(to be) the 7th entity in a sequence
nš|PROPER BEHAVIOR/MANNERS/CIVILITY|(to be) well-behaved|(to be) well-mannered|(to be) having decorum/civility|(to be) having/displaying dignity|(to be) polite/courteous|(to be) well-bred/noble/distinguished
nt|SEQUENTIAL ENUMERATION|(to be) counting entities to determine quantity thereof|(to be) sequential numerical labeling for ordering/identifying|(to be) a numerical pattern/arrangement, enumeration
nţ|BIRTH/GESTATION/CONCEPTION|(to be) born/giving birth|(to be) maternal gestation|(to be) biological conception
nv|BUTTERFLY/MOTH|butterfly|moth|moth-butterfly
nx|DEGREE OF FURTIVENESS/COVERTNESS|(to be) furtive/covert|(to be) obscure/obfuscated/difficult to discern/interpret|(to be) sneaky/stealthy/surreptitious
ny|CHOICE/ALTERNATIVE|(to be) a choice (to be) made|(to be) a preference|(to be) settling for something (reluctantly)|(to be) selecting/picking (from limited options)|(to be) an alternative/available option|(to be) voting
nz|GOODWILL/FRIENDLINESS/BEING NICE|(to be) nice to another party|(to display/show) goodwill/kindness|(to display/show) amicability/friendliness|(to be) good samaritanship|(to be) peace/fellowship|(to be) friendship (unidirectional)
nž|MALINE FRUIT PLANT/TREE 1|apple (Malus domestica)|crabapple (genus Malus)|pear (genus Pyrus)
ňb|RESILIENCE/CAPACITY OF RECOVERY|degree of resilience|decrease in resilience|increase in resilience
ňc|RELUCTANCE/SQUEAMISHNESS/COWARDICE|feel reluctance|feel squeamishness|feel cowardice
ňç|EXTRACTION|extracting/drawing out/forth|removing something from a surrounding medium/substrate|obtaining/drawing out something from a surrounding medium/substrate
ňč|INFLUENCE/PERSUASION/PREDOMINANCE|(to be) influencing/influential|(to be) persuasion/persuading|(to be) preponderant/predominant|(to be) stimulation/rousing/inciting|(to be) encouragement|(to be) advocacy
ňd|DURABILITY/FRAGILITY|degree of durability|decrease in durability|increase in durability
ňḑ|VACCINIUM SHRUB 1|blueberry shrub (Vaccinium)|cranberry shrub (Oxycoccus)|huckleberry/whortleberry shrub (V. myrtillus)
ňf|PROBLEM/MYSTERY|(to be) a problem/issue causing inconvenience/impediment|(to be) a mystery/puzzling situation|(to be) something irksome/annoying
ňh|FEEL FLUSHED/PERSPIRATION/FATIGUE|feel sweaty|feel physical fatigue|feel flushed
ňj|AWARENESS|noticing/taking note of something|being aware of something|keeping/bearing something in mind
ňl|U-SHAPED OUTLINE
ňļ|EXISTENCE/REALITY/SOLIPSISM|(to be) something ontologically existent/real|(to be) something epistemologically real|(to be) solipsistic existence (i.e. of one's own psyche)
ňm|SURFACE APPLICATION/OVERLAY/PAINT|applying a liquid/viscous substance/material to a surface|spreading/overlaying a substance/medium onto another|painting a surface
ňn|OXYGEN|oxygen|O ion w/missing electron(s)|O ion w/additional electron(s)
ňň|CHEMICAL-LIKE FLAVOR|chemical-like flavor|metallic flavor|astringent/acidic flavor
ňp|COMMON HUMAN BODILY POSITIONS|(to be) standing upright/erect|(to be) sitting/seated|(to be) lying prone/down
ňr|ORANGE|orange (color)|reddish orange|ochre
ňř|IMPEDIMENT/RESTRICTION/PREVENTION|(to be) something under restriction/impeded/blocked|(to be) under restraint/held back|(to be) preventing something from happening
ňs|REPUTATION/PUBLIC IMAGE/PRESTIGE|(to be) one’s reputation|(to be) one’s public image|(to be) one’s sense of prestige
ňš|AUTUMN|(to be) autumn/fall|(to be) the flora withering/dying during autumn|(to be) the autumn equinox
ňt|PRIVACY/SECLUSION/ISOLATION|(to be) private|(to be) secluded/solitary|(to be) isolated
ňţ|DEGREE OF ACCURACY/SUITABILITY/LEGITIMACY|(to be) a degree of accuracy/correctness|(to be) a degree of suitability/fitness|(to be) a degree of legitimacy/orthodoxy
ňv|JOY/HAPPINESS|feel merriment/delight/jollity|feel happiness|feel jubilation
ňw|NECK|neck|neck (as support for head)|neck (as vulnerable body part)
ňz|CRITICIZE/DISPARAGE/DENIGRATE|criticizing/disparaging/denigrating|rebuking/scolding/berating/reproaching|defaming/slandering/libeling
ňẓ|EMOTIONALISM/WHIM-WORSHIPPING/MYSTICISM|(to be) emotion/melodrama driven in one’s daily decisions|(to be) whim-driven in daily decisions|(to be) relying on mysticism/supernatural for one’s life decisions
ňž|ARRANGEMENT/ORDER/SYMMETRY|arranging/being arranged|ranking hierarchically|arranging symmetrically
pc|TEN THOUSAND|(to be) a set/group of 100² entities|(to be) something with 100² aspects/facets|(to be) the 100²-th entity in a sequence
pç|READ/RECITE/ERUDITION|reading, gathering information through writing|reading aloud/reciting|acquiring knowledge/expertise via reading
pč|MOUTH/GULLET/ORAL CAVITY|mouth|gullet (plant, protist)|bodily apparatus/process for food ingestion
pd|GRAB/PICK UP/MANIPULATE|grabbing something with one's manipulative appendages|picking something up or out of something else|handling something with one's manipulatory appendages
pḑ|FOOTFALL/BODILY MOVEMENT/ORAL SOUND|sound of stepping/pattering|sound of a body moving|non-linguistic oral sound (clicks, swallowing)
pf|FRONT PART OF AN ENTITY
pg|FOOLING/PSYCHO-LINGUISTIC MANIPULATION/HYPNOSIS|(to be) fooling another party (into something)|(to be) toying with someone, manipulating them to make them feel bad|(to be) hypnotizing someone
ph|DEGREE OF PRECISION/DEFINITION/SCRUTINY|(to be) a degree of precision/exactness|(to be) a degree of (well-)definition/precision thereof|(to be) a degree of scrutiny/attention
pj|JUSTIFICATION/VINDICATION/EXHONDERATION|(to be) justification|(to be) vindication (being proved right after the fact)|(to be) exoneration/acquittal
pk|POSITION BETWEEN IN 2D|position amidst 2D|toward a position in 2D midst|vicinity of a position in 2D midst
pl|MOTION ALONG PARABOLIC/ARC-LIKE TRAJECTORY
pļ|TURN/ROTATION/SPIN|(to be) be turning/rotating|(to be) revolving (following a circular motion around something)|(to be) spinning (revolving in place)
pn|UPPER GASTROINTESTINAL ORGANS|stomach|esophagus|pancreas
pp|PICK UP/GATHER/AMASS|(to be) taking/picking up something to keep it|(to be) gathering something (making into a group)|(to be) amassing/piling up/growing in amount|(to be) procurement/acquiring|(to be) collection/collecting|(to be) accumulation/accretion
pr|VERTICAL QUASI-LINEAR MOTION|vertical quasi-linear motion|ascent/ascend/rise|descent/descent
př|ACCESS/ENTRY/EXIT|(to be) a 2-way access point/passageway|(to be) an entry point/entry portal|(to be) an exit point/exit portal
ps|HAPPEN/MANIFEST/EVENT|(to be) an occurrence of something, happening|(to be) manifesting, be/make real|(to be) an event (spatiotemporal)|(to be) a step/act/action|(to be) a phenomenon|(to be) an incident
pš|FOUR/QUATERNARY|(to be) a set/group of 4 entities|(to be) something with 4 aspects/facets|(to be) the 4th entity in a sequence
pt|DEGREE OF RISK/DANGER|(to be) a degree of physical risk/danger|(to be) a degree of emotion risk/danger|(to be) a degree of social(ly-oriented) risk/danger
pţ|SEEK/SEARCH|searching/seeking/looking for something unknown|searching/seeking/looking for something lost|questing/seeking to accomplish something|exploring|pursuing/tracking down (existence certain, location unknown)|hunting (for)
pv|IGNORE/DISREGARD/STATE OF DENIAL|ignoring something/someone (act as though they don’t exist)|disregarding something/someone (not taking into account)|denying something (important, falsely thinking it to be inconsequential)
pw|FRONT+BELOW (0/+Y/-Z)|position in front & below|forward & downward|area ahead & below
px|SUID|domestic pig|wild boar|warty/bearded pig
py|FRONT+ABOVE (0/+Y/+Z)|position in front & above|forward & upward|area ahead & above
pẓ|RHINOCEROS|Indian/Javan rhino|Sumatran rhino|African white & black rhino
rb|MEANING/EXPLANATION/INTERPRETATION|meaning/signifying/denoting something|explaining something|interpreting something (act as skilled medium for an audience)|defining something|expounding/elucidating something|translating something
rc|COINCIDENCE/SIMULTANEITY|(to be) coinciding/coincidence (not necessarily simultaneous, but auspiciously timed)|(to be) simultaneous (without awareness of the other event)|(to be) synchronicity (unlikely coincidence rousing suspicion)
rç|AESTHETIC APPEAL/PRETTINESS/BEAUTY|perceiving/experiencing something as aesthetically appealing|perceiving/experiencing something as pretty/fair/lovely|perceiving/experiencing something as beautiful
rč|DAMAGE/UNDERMINE/LESSEN|physically damaging (CPT=wreck/destroy)|rendering less than fully functional (CPT=ruin/devastate)|reducing the presence/existence (CPT=eradicate/eliminate/annihilate)
rd|DEGREE OF TRUTH/GENUINENESS/FACTUALITY|(to be) a degree of truth/veracity/reality|(to be) a degree of authenticity/genuineness|(to be) a degree of validity/factuality
rḑ|CONVENTIONALIZED TIME PERIODS|(to be) a calendrical/designated day|(to be) a calendrical/designated week|(to be) a calendrical/designated month
rf|AMOUNT/PORTION/ALLOCATION|(to be) an amount/quantity of uncountable substance|(to be) a share/portion to distribute|(to be) an allotment/allocation|(to be) a measure/dose of substance/entity|(to be) an official share/ration|(to be) an official quota/allocation
rg|DEGREE OF STEADFASTNESS/MOBILITY/INDELIBILITY|(to be) a degree of steadfastness/durability (can’t be altered)|(to be) a degree of mobility/activity (can’t be moved)|(to be) a degree of indelibility/fixedness (can’t be removed/erased)
rh|BEAR|black bear|grizzly bear|big brown bear
rj|EMBARRASSMENT/SHAME/HUMILIATION|(to be) embarrassment|(to be) shaming someone, making feel shame|(to be) humiliation/abasement
rk|DEGREE/RANGE/INTENSITY|(to be) the degree/extent of something (amount of effect/impact)|(to be) the range of something (measure of figurative limit)|(to be) the intensity of something (measure of strength)
rl|SENTIENCE/SUBJECTIVITY|(to be) sentience/sentient|(to be) subjectivity/subjective|(to be) a subjective experience
rļ|SILVER|silver|Ag ion w/missing electron(s)|Ag ion w/additional electron(s)
rm|DWELLING/DOMICILE/HOUSE|(to be) a dwelling/abode, where an entity dwells/lives|(to be) a domicile (artificial dwelling for protection)|(to be) a house (constructed residence with conveniences)
rn|LONGER TIME PERIODS|(to be) up to/most of a year|(to be) up to/most of a decade|(to be) approx. a lifetime|(to be) a calendrical year|(to be) a calendrical decade|(to be) a designated lifetime of an individual
rp|CYCLE/PATTERN/ITERATION|(to be) something with a cycle/pattern of regularity|(to be) something with a particular cycle/pattern of regularity|(to be) something manifesting iteration/recurrence
rr|CAT|cat (domestic)|wildcat|leopard/fishing/rusty-spotted/Palla’s cat
rs|SINCERITY/HONESTY/GUILELESSNESS|(to be) sincere/personally genuine|(to be) honest (without deceit)|(to be) guileless (without ulterior motive)
rš|STAGE/STEP/PHASE OF A PROCESS|(to be) a step/stage/phase in a process|(to be) a degree/grade on a progressive/scalar gradient|(to be) a section/sub-unit/discernible potion of a structured entity
rt|SUFFICIENCY/ADEQUACY|(to be) a sufficient amount/extent/degree of something|(to be) an adequate amount/extent/degree of something|(to be) something to a satisfactory degree/extent
rţ|ANNOYANCE//BOTHER/HARASSMENT|annoying/vexing/irritating|bothering/pestering/nagging|harassing
rv|TEMPORARY DURATION|(to be) a moment/instant|(to be) a “while”|(to be) a portion of a day
rw|SHORT-TERM CONVENTIONALIZED TIME PERIOD|(to be) a second|(to be) a minute|(to be) an hour
rx|DEGREE OF SIMILARITY/RESEMBLANCE|(to have) similarity/resemblance to another concrete entity|(to have) similarity/resemblance to oneself on another occasion|(to have) similarity/resemblance to another abstract situation
ry|FREEDOM/SELF-DETERMINATION/INDEPENDENCE|(to be) free, not subject to another’s restriction/oversight|(to be) self-determined, determining oneself|(to be) independent, unaffiliated with another party
rz|AUTHORITY/OBEDIENCE|(to be) enforceable authority and obedience thereto|(to be) mastery/parental authority and obedience thereto|(to be) enforceable governmental authority and obedience thereto|(to be) contractual occupational authority (i.e employer) and compliance thereto|(to be) slavery and subjugation thereto|(to be) military authority and obedience thereto
rẓ|CHEMICAL ELEMENT|(to be) a chemical element|(to be) a positive ion of a chemical element|(to be) a negative ion of a chemical element
rž|REVENGE/VENGEANCE/VINDICTIVENESS|(to be) revenge/vengeance|(to be) retaliation|(to be) vindictiveness, desire for revenge
řb|QUALITY/ATTRIBUTE/PROPERTY OF MATTER|degree of a particular quality/attribute|decrease in a particular quality/attribute|increase in a particular quality/attribute
řc|THROAT|throat (front portion of neck)|upper portion of throat (jaw underside)|lower portion of throat (overlying gullet/trachea)
řç|MORACEAE 1|fig tree|mulberry tree|African breadfruit tree
řč|DEGREE OF FUNCTIONALITY/ACTIVITY/EFFICACY|(to be) operationally functional/in working order|(to be) active (extent to it’s acting/functioning)|(to be) efficacious (extent to which it achieves its expectations)
řd|REMEDY/HEAL/RESTORE|medically treating/remedying|recuperating/healing/recovering|restoring
řḑ|DEGREE OF EXACTITUDE|(to have) a degree of exactitude (expected equivalence)|(to have) a particular degree of exactitude (accuracy relative to standard)|(to be) something serving/functioning/substituting (relative to some standard)
řf|FOOLING/LEGERDEMAIN/MAGIC TRICK|fooling/duping someone (make them appear naive/gullible)|(to be) legerdemain|(to be) a magic trick (for entertainment)
řg|DEGREE OF CONFORMITY/TYPICALNESS|conforming to a norm/stereotype/standard|being commonplace/typical/run-of-the-mill|being original/innovative/out of the box
řh|DEGREE OF TRUSTWORTHINESS/RELIABILITY/DEPENDENCY|(to have) trust(worthiness), belief in reliability of another|(to have) reliance upon (helped by another)|(to have) dependency upon (determined by another)
řj|PRIVACY VIOLATION/STALKING/ASSAULT|violating the privacy of another|stalking another|assaulting (non-consensual physical contact) another
řk|POSSESSION/OWNERSHIP/PROPERTY|physical possession (alienable)|having affectively (e.g., a seat, medical condition)|having intrinsically|physical owning (alienable)|owning (alienable)|owning legally (inalienable)
řl|MISTAKE DISCOVERED THROUGH HINDSIGHT|changing one’s mind after consequences of a decision/opinion|discovering one has misread/misjudged a party after having acted|finally understanding a previously complex situation when it’s too late
řļ|CREAKING/SQUISHING/TEARING|sound of creaking|sound of squishing/squelching|sound of tearing
řm|DIMNESS/PALENESS/SHADOW|(to be) dim/dimming (difficult to see)|(to be) pale/blanched/pallid/wan|(to be) in the shade or in shadow|being/making something dull/lackluster (decreased reflectivity)|being/making something faded (loss of previous brightness)|being/making something murky/gloomy
řn|HANG/DANGLE/OVERHANG|suspending/hanging something (up)|dangling something|overhanging/jutting (out)
řň|EPOCH-LENGTH TIME PERIODS|(to be) a geologic age|(to be) a geologic epoch|(to be) a geologic era
řp|DEGREE OF SPECIALNESS/UNIQUENESS/MARVELOUSNESS|(to be) special/extraordinary|(to be) unique|(to be) marvelous/wonderful/awesome
řř|INTENSIFICATION/AMELIORATION/AGGRAVATION|(to be) intensifying/heightening|(to be) ameliorating/bettering|(to be) aggravating/worsening
řs|ACCEPTANCE/CONSENT/AGREEMENT|(to be) a degree of acceptance/tolerance|(to be) a degree of assent/consent|(to be) a degree of agreement/accordance|(to be) a degree of permission|(to be) affirming/confirming/formally recognizing|(to be) approving/endorsing
řš|SHYNESS/BASHFULNESS/TIMIDITY/COWARDICE|(to be) diffident/shy/bashful|(to be) timid/timorous|(to be) cowardly/faint-hearted
řt|RUBUS PLANT 1|raspberry plant|blackberry plant|dewberry plant
řţ|LONG-TERM TIME PERIOD|(to be) a calendrical century|(to be) a calendrical millennium|(to be) a calendrical ten-thousand year period
řv|CONSEQUENCE/OUTCOME/RESULT
řw|CLARITY/PERSPICUITY/PELLUCIDITY/EXPLICITNESS/PRECISION/METICULOUSNESS
řx|PHYSICAL PAIN|feel external tactile pain|feel interoceptive/proprioceptive pain|feel muscular strain
řy|DEGREE OF CAPACITY FOR EMOTION
řz|DISINTEREST/PROBITY/HONESTY/SUBLIMITY/NOBILITY/VIRTUE
řž|FRAGARIA|wild strawberry plant|strawberry cultivar|strawberry hybrid
sb|SMOOTH/ROUNDED TEXTURE|smooth|rounded/knobbed|dull/blunt
sc|WASH/BATHE/RINSE|washing with water/liquid cleansing solution|bathing|rinsing/flushing/showering
sč|BREAK APART/BREAK INTO PIECES/CRUMBLE|breaking something apart/open|breaking something into pieces|crumbling something into non-discrete pieces
sd|BOUNCY/ELASTIC TEXTURE|bouncy texture|elastic/stretchy texture|sponge-like recoiling texture
sf|SENSE OF TASTE/THE TASTE OF SOMETHING|(to be) the flavor of something and tasting thereof|(to be) a taste bud|(to be) one’s sense of taste|(to be) a willful tasting of something|(to be) using a gustatory device/instrument|(to be) an induced gustatory experience
sg|SLICK/SLIPPERY TEXTURE|slick to the touch|slippery|slimy
sh|AIR|(to be) air being present in a spatio-temporal location|(to be) “fresh” air being present (let in from outside)|(to be) “stale” air being present
sj|COMBINE/MIX/SYNTHESIZE|(to be) combining multiple entities (bring together to function as one)|(to be) mixing multiple entities (to have them associate/interact)|(to be) synthesizing (combine elements into a single entity)|(to be) mixing/blending multiple entities (bring together into a single entity)|(to be) synergy|(to be) synergy with emergent properties
sk|CONTAIN/HOLD/CONTENTS
sl|THOUGHT/IDEA/CONTEMPLATION/CONCEPT/REASON/ANALYZE
sļ|FAUX PAS
sm|DEGREE OF BODILY APPLIED ENERGY/POWER/FORCE
sn|CHANGE/VARIATION/DEVIATION/ALTERATION
sň|ORAL-NASAL REFLEX
sp|DEGREE OF NEWNESS
sř|ROOM/CHAMBER/COMPARTMENT|room/chamber|compartment|cubicle/partitioned section of a larger room
ss|TOOL/INSTRUMENT
sţ|MAGNANIMITY/ACCEPTING/TOLERANCE/RESIGNATION
sv|EUKARYOTIC LIFE FORM
sw|PLANETARY BODY
sx|COMPLAINT/GRIEVANCE
sy|SUBSTANCE/MATERIAL/MATTER
šč|MONEY/FINANCIAL TRANSACTION/BANKING
šd|SLUSHY/MUSHY TEXTURE
šf|DEGREE OF NATURAL CAPACITY/TALENT/SKILL
šg|CAPTURE/APPREHENSION/SEIZURE/DETENTION/USURPATION
šj|BEING BUSY/OCCUPY ONESELF/ACTIVITY/DUTY/JOB/OBLIGATION
šk|EXTERNAL SENSATION/EXTERNAL SENSORY PERCEPTION
šl|THINNESS/THICKNESS|degree of thinness|decrease in thinness|increase in thinness
šm|MANIPULATIVE/AMBULATORY APPENDAGE
šn|LEG
šň|INFLATION/PRESSURIZATION/VENTILATION
šp|COLOR
šr|MOOD/TEMPERAMENT/COUNTENANCE/BEHAVIOR
šř|SPACETIME/SPACE/PASSAGE OF TIME|(to exist/occur at) a location/instance in spacetime|(to be/occupy) a location in space|(to occur at) a point/period in time
št|WAIT/AWAIT/VIGIL/FORESEE/FORECAST
šţ|RECOGNITION/CONSIDERATION OF ANOTHER'S PERSPECTIVE/COMPROMISE’
šv|PLAY/RECREATION/SPORT
šw|LIFE FORM, LIVING THING
šx|ARROGANCE/HAUGHTINESS/INSOLENCE
šy|RAISE/FOSTER/NURTURE/CULTIVATE
tb|AUDACITY/“NERVE”/CONFRONTATION/DEFIANCE
tç|INTENTION/DECISION/DETERMINATION/PURPOSE/JUDGEMENT/RESOLUTION
tf|ADDITION/SUBTRACTION|adding/subtracting|adding|subtracting
tg|PAPERY/FOIL-LIKE TEXTURE
th|DEGREE OF RELIABILITY/INFALLIBILITY/QUALITY
tk|POSITION BETWEEN IN 3D|position amidst 3D|toward a position in 3D midst|vicinity of a position in 3D midst
tl|GENERIC/OBLIQUE 3-DIMENSIONAL RANGE OF MOTION, i.e., 3D pervasive movement throughout or within a volume of space
tļ|COMMENCEMENT/ACTIVATION/INITIATION/INSTIGATION
tm|ENERGY EXPENDITURE/EFFORT/WORK/OPERATION/FUNCTIONING/ACTION
tn|MAMMAL
tp|MINDFULNESS/ALERTNESS/WARINESS/CAUTION
tr|PATH-ORIENTED, QUASI-LINEAR TRANSLATIVE MOTION
tř|RESPECT/ESTEEM/HONOR
tt|SALUTATION/GREETING/INTRODUCTION/FAREWELL
tv|APPEAR/MANIFEST/SHOW/EXHIBIT/DISPLAY
tw|DREAM
tx|EAT/DRINK/NUTRITIONAL CONSUMPTION
ty|HEAD
ţb|TIDINESS/ORDERLINESS/GROOMING
ţc|RECTILINEARITY/STRAIGHT-ANGLEDNESS/POINTINESS|degree of rectilinearity/pointiness|decrease in rectilinearity/pointiness|increase in rectilinearity/pointiness
ţč|SIGN/MARK/SYMBOL/VISUAL MEANS OF INDICATION/REPRESENTATION
ţf|POSITIONALLY-DEFINED COMPONENTIAL PART
ţg|SELF-INTEREST/INDIVIDUALITY/INTEGRITY
ţj|EMPHASIS/HIGHLIGHT/UNDERSCORE/IMPRESS UPON/RAVE ABOUT
ţk|MAKE/CONSTRUCT/INTEGRATE/FORM
ţl|ANIMALS OF THE AIR (i.e., capable of self-powered flight)
ţm|DEGREE OF INTENSITY
ţn|VITUS|European grapevine (Vitus vinifera)|grapevine (Vitus labrusca, riparia, aestivalis, rotundifolia, etc.)|wild/ornamental grapevine
ţň|FILL/INUNDATE/STUFF
ţp|FACULTY/ATTRIBUTE/QUALITY/TRAIT/PROPERTY/CHARACTERISTIC
ţr|WATER
ţs|COVERING/SUPERIMPOSITION/ENCASEMENT /SHEATH
ţš|INTROSPECTIVE CONTEMPLATION/ETHICAL WELL-BEING AND GROWTH
ţt|FACT/KNOW/STUDY/LEARN
ţţ|SIDE/FLANK OF AN ENTITY*
ţv|INTELLIGENCE/ASTUTENESS/PERSPICACITY
ţw|DOWN/BELOW (0/0/-Z)|position down/below position|downward|vicinity below
ţx|EXAGGERATION/EMBELLISHMENT/OVERSTATEMENT/HYPERBOLE/OVER-REACTION
ţy|UP/ABOVE (0/0/+Z)|position up/above|upward|vicinity above
vb|LEFT+FRONT (-X/+Y/0)|position left & in front|leftward & forward|area left & ahead
vc|GROOVED/STRIATED TEXTURE
vč|OUTWARD EXTENT|degree of 3D extension|decrease in 3D extension|increase in 3D extension
vd|SHARPNESS
vg|LEFT+BEHIND (-X/-Y/0)|position left & behind|leftward & backward|area left & behind
vh|DEGREE OF DESIGN/ORDER/ORGANIZATION/SYSTEMATIZATION
vj|AMPLITUDE|degree of amplitude|decrease in amplitude|increase in amplitude
vk|ATTRACTION
vl|REALIZATION/UNDERSTANDING/COMPREHENSION
vm|MAGENTA|magenta|fuchsia|rose (color)
vn|BASIC ANIMAL TYPES
vp|LAXITY/LENIENCY/NEGLIGENCE
vr|ZERO/NULL|empty set/group|zero-dimension|baseline null-state in a sequence
vs|SEASON
vš|SUBTLETY/SLYNESS/SHREWDNESS/GUILE/CRAFTINESS
vt|STRINGY, FIBROUS TEXTURE
vţ|FLAKY/SCALY TEXTURE
vw|LEFT+BELOW (-X/0/-Z)|position right & below|rightward & downward|area right & below
vx|SEMI-HARD/SEMI-RIGID TEXTURE
vy|LEFT+ABOVE (-X/0/-Z)|position right & above|rightward & upward|area right & above
vẓ|SUBJECTIVE INTERPRETATION/“READING”
xb|TENSENESS/TENSION (= STRAIN)
xc|EQUINE|horse (E. ferus)|ass/donkey, kiang, onager (E. asinus)|zebra (E. hippotigris)
xd|TIGHTNESS/SLACK (= TAUTNESS)
xḍ|EXTERNAL POINT-LIKE OUTWARD-FACING VERTEX/CORNER OF AN ENTITY
xf|EXTERNAL ATTACHMENT POINT OR FASTENING MECHANISM OF AN ENTITY, i.e., handle, hook, latch, velcro patch, knob, peg, etc.
xj|TAPIR|Central American tapir (T. bairdii)|South American tapir, mountain tapir (T. terrestris, pinchaque)|Asian tapir (T. indicus)
xk|EXTERNAL QUASI-LINEAR JOINING OF SURFACES/“SEAM” OF AN ENTITY
xl|INTERIOR SURFACE OR WALL/INTERNAL SURFACE OR WALL/THE INSIDE SURFACE OR “WALL” OF AN ENTITY
xm|BLACK|black|dark-shaded|obscured by low light/shadow
xn|SENSATION OF COOLNESS
xp|SUBSTITUTION/TRANSPOSITION/REPLACEMENT
xr|EXTERIOR/EXTERNAL SURFACE/“OUTSIDE”/“SKIN” OF AN ENTITY
xt|EXTERNAL QUASI-LINEAR EDGE OF AN ENTITY
xţ|DEGREE OF CONCERN/EMPATHY/CARE/INDIFFERENCE/NEGLECT
xv|EFFORT/WORK/POWER/OPERATE/FUNCTION
xw|INTERIOR/INTERNAL VOLUME/“INSIDE(S)”/“INNARDS” OF AN ENTITY
xx|FOUL/RANCID FLAVOR
xẓ|DUSTY/POWDERY TEXTURE
zc|CHOP/DICE/MINCE
zč|SELF-CONCERN/SELFISHNESS/SELF-CENTEREDNESS
zd|COMPARISON/CONTRAST/MEASUREMENT/DISTINGUISH
zḑ|FORESIGHT/PREDICTION/PROGNOSTICATION
zf|GUMMY/RUBBERY TEXTURE
zg|BITTER FLAVOR
zh|DESERT/STEPPE/TUNDRA
zj|CONCEALMENT/SECRECY
zk|STRANGENESS/ODDITY/WEIRDNESS
zl|WEATHER/CLIMATE
zm|FLEE/ESCAPE/EVASION/ELUDE/SHIRK
zn|MANUAL MANIPULATION
zp|SOLANUM 1|potato plant (S. tuberosum)|tomato plant (S. lycopersicum)|eggplant/aubergine plant (S. melongena)
zr|TENDENCY/INCLINATION/APTNESS/TREND/PREDISPOSITION/BIAS
zř|SLICE/PLANE/SHAVE/SHRED
zt|ARACHNID|spider/harvester (harvestman, daddy longlegs)|scorpion/solifuge (wind scorpion, camel spider, sun spider)|tick/mite
zţ|ABSORPTION/IMBUEMENT/INFILTRATION/SOAK/DIFFUSION/PERMEATION/OSMOSIS
zv|DOG|dog (Canis lupus familiaris/dingo)|gray wolf (Canis lupus)|coyote/American jackal (Canis latrans)
zx|TINGLY/VIBRATING TEXTURE
zy|SPRING (SEASON)/SPRING-RELATED NATURAL PHENOMENON
zz|REPTILE
zẓ|BINARY POLARITY/SWITCHING|degree of binary switching|decrease in binary switching|increase in binary switching
ẓb|PLANARITY/LOCAL FLATNESS|degree of local flatness|decrease in local flatness|increase in local flatness
ẓč|CARVE/GUT/EVISCERATE
ẓd|GIRTH/CIRCUMFERENCE
ẓḑ|BURROW/HOLLOW OUT or LINEAR CURVATURE
ẓf|PIERCE/PUNCTURE/BREACH/HOLE/TUNNEL
ẓg|ACHE/SHARP PAIN/RADIATING PAIN
ẓh|ROUGH/BRISTLY TEXTURE
ẓj|INTIMIDATION/THREAT/MENACE
ẓk|SELF-RIGHTEOUSNESS/SANCTIMONIOUSNESS/HYPOCRISY
ẓl|PLANAR 2-DIMENSIONAL MIDDLE, CENTER RUNNING VERTICALLY AND LATERALLY PARALLEL TO LONG (OR TALL) SIDE OF ENTITY
ẓm|HEEDLESSNESS/IMPETUOSITY/IMPRUDENCE/INDISCRETION/TEMERITY/FOOLHARDINESS/RASHNESS
ẓn|AFFECTIVE SEXUAL RESPONSE
ẓr|PLANAR 2-DIMENSIONAL MIDDLE, CENTER RUNNING VERTICALLY PARALLEL BUT LATERALLY PERPENDICULAR TO LONG (OR TALL)
ẓř|SLOT/GROOVE/FURROW
ẓt|LAW/STATUTE/LEGAL COMPLIANCE
ẓţ|3D SHAPELESSNESS|degree of 3D shapelessness|decrease in 3D shapelessness|increase in 3D shapelessness
ẓv|MULTIPLICATION/DIVISION|multiplying/dividing|multiplying|dividing
ẓw|PLANAR 2-DIMENSIONAL MIDDLE, CENTER RUNNING VERTICALLY AND LATERALLY PERPENDICULAR TO LONG (OR TALL) SIDE OF
ẓx|OUTWARD SPREAD|degree of 2D spread|decrease in 2D spread|increase in 2D spread
ẓẓ|HELP/AID/ASSISTANCE/SUPPORT/ADVOCACY
žč|WISTFULNESS|feel wistful/longing/yearning|feel sentimentality/nostalgia|feel saudade
žg|SMELL/ODOR
žj|ARTHROPOD
žk|BRASSICA OLERACEA 1|broccoli plant (B.o. Italica)|cauliflower, romanesco, or broccoflower plant (B.o. Bortryti)|Chinese broccoli plant/gai lan, broccolini hybrid (B.o. Alboglabra)
žl|VIOLET|violet|purple|violetish magenta
žm|OUTLOOK-ON-LIFE/SENSE-OF-LIFE/PERSONAL VALUE/CHARACTER
žn|IMPULSE/PUSHING/PROPULSION
žr|THROWING/LAUNCHING/SHOOTING
žř|TEASE/RIDICULE/DERISION/MOCKERY/PARODY/SATIRE
žt|MODESTY/HUMILITY
žţ|VARIATED TEXTURE
žv|GOOD/BENEFICIAL
žw|CLEANLINESS/PURITY/ SANITATION/HYGIENE
žx|FIRE/BURNING /MELTING/CALEFACTION
žy|SUPPORTIVENESS|feel supportive (w/o self-sacrifice)|desire to help accomplish something|desire to find meaning by making a difference 
žž|NOSINESS
b[d]bl|SINK|service of sink|use of sink|non-use of sink
bbr|WASHBASIN|service of washbasin|use of washbasin|non-use of washbasin
bbř|BIDET|service of bidet|use of bidet|non-use of bidet
bbw|BATHTUB|service of bathtub|use of bathtub|non-use of bathtub
bby|SHOWER STALL|service of shower stall|use of shower stall|non-use of shower stall
bdw|VAGINAL TISSUE
bdy|MISC. AUTONOMIC BODILY PROCESSES
bḑn|BENINCASEAE|watermelon (genus Citrullus)|winter melon/wax or ash gourd  (genus Benincasa)|tinda/Indian squash/round melon (genus Praecitrullus)
bḑw|CUCUMIS 2|honeydew melon plant|Crenshaw melon plant|casaba melon plant
bḑy|CUCUMIS 3|cucumber vine|cackrey/West Indian gherkin vine|aardvark cucumber/aardvark pumpkin vine
bgl|TOPOLOGICAL INVERSION
bšt|RELIGIOUS LEADER⬌DISCIPLE|(be) the state/act of a religious leader⬌disciple relationship|(be) the state/act of a religious leader|(be) the state/act of a religious disciple
bţr|OUTDOOR SWIMMING POOL|service of swimming|use of swimming pool|non-use of swimming pool
bvr|PUREE-BASED SOUP
bvy|GRUEL/PORRIDGE
bzd|CHINCHILLA/VISCACHA/PACARANA|(genus Chinchilla) chinchilla|(genera Lagidium, Lagostomus)  viscacha
bzl|SQUIRREL|(genera Spermophilus, Urocitellus,  Notocitellus, Ammospermophilus, Otospermophilus, Callospermophilus, Xerospermophilus,  Ictidomys,
bzm|RAT|(Murid/Old world rats; Murines, Lophiomyines, Leimacomyines — numerous genera) rat
bzn|MOUSE|(Murid/Old world mice; numerous genera) mouse
bzr|VOLE/LEMMING/MUSKRAT|(genera Arvicola, Blanfordimys, Chionomys, Lasiopodomys, Lemmiscus, Microtus, Neodon, Phaiomys, Proedromys, Volemys,
bzř|HAMSTER|(genera Cricetus, Allocricetulus, Cansumys, Tscherskia)  hamster|(genus Mesocricetus) golden hamster|(genera Cricetulus, Phodopus) dwarf
bzv|DORMOUSE|(genera Glirulus, Glis)  dormouse|(genus Graphiurus)  African dormouse|(genera Chaetocauda, Dryomys, Eliomys, Muscardinus,
bzw|BEAVER|(Castor canadensis) North American beaver|(Castor fiber)  Eurasian beaver|(genus Aplodontia) mountain beaver
cgv|JUNCTURE OF KINEMATIC PAIR
ckr|CLOSED LINEAR OUTLINE SHAPE
ckw|FLIMSINESS/COHESIVENESS/STRUCTURAL INTEGRITY/STABILITY
cpl|LIMPNESS/FLACCIDITY/JIGGLINESS/FLABBINESS
ççp|NEGATIVE FACIAL EXPRESSION
ççt|CONTEMPLATION OF MORTALITY
çdr|LEVERAGE
çmy|BUFFER/INTERVENING PROTECTIVE MEDIUM
çpl|SECRETION/RESIN/SAP
çtr|PUZZLE/RIDDLE
çty|NORTH/SOUTH/LONGITUDE
čtř|BADGER|(genus Taxidea) American badger|(genus Meles) European/Asian/Japanese badger|(genus Arctonyx) hog badger
ddw|SAGE/GURU⬌DISCIPLE|(be) the state/act of a sage⬌disciple relationship|(be) the state/act of a sage/guru|(be) the state/act of a disciple
dbr|TOWER/SPIRE|tower w/dwelling|tower w/ancillary space|spire on a building
ddy|TEACHING⬌STUDENT|(be) the state/act of a teacher⬌student relationship|(be) the state/act of teaching|(be) the state/act of a student
dgl|PLANAR ORIENTATIONAL INVERSION
dkl|NON-BALLISTIC WEAPON|(to be) a hand-held/hand-thrown bladed weapon|(to be) a pointed-tipped weapon for piercing|(to be) a blunt force-driven weapon
dkr|BALLISTIC WEAPON
dkw|MICROBIAL, SONIC, CYBER- WEAPON
dny|EAST/WEST/LATITUDE
drr|APPEAR/MANIFEST/SHOW/EXHIBIT/DISPLAY/EXPOSE/ANNOUNCE
ḍbl|MERCURY|mercury|Hg ion w/missing electron(s)|Hg ion w/additional electron(s)
ḍbr|COPERNICIUM|copernicium|Cn ion w/missing electron(s)|Cn ion w/additional electron(s)
ḍbř|ATYPICAL FACIAL EXPRESSION
ḍbw|ZINC|zinc|Zn ion w/missing electron(s)|Zn ion w/additional electron(s)
ḍby|CADMIUM|cadmium|Cd ion w/missing electron(s)|Cd ion w/additional electron(s)
ḍgř|QUEASINESS/NAUSEA/VOMITING
ḑny|MILK FROM MAMMAL
fkl|PHYSICAL SPATIO-TEMPORAL EXTENSION|linear extension/reach|2D extension/spread|3D extension
fkw|RIGHT+BEHIND+BELOW (+X/-Y/-Z)|position right, behind, & below|rightward, backward, & downward|area right, behind, & below
fky|RIGHT+BEHIND+ABOVE (+X/-Y/+Z)|position right, behind, & above|rightward, backward, & upward|area right, behind, & above
fpw|RIGHT+FRONT+BELOW (+X/+Y/-Z)|position right, in front, & below|rightward, forward, & downward|area right, ahead, & below
fpy|RIGHT+FRONT+ABOVE (+X/+Y/+Z)|position right, in front, & above|rightward, forward, & upward|area right, ahead, & above
fst|PROKARYOTIC, NON-VISIBLE LIFE FORMS
ftř|ABNORMAL AFFECTIVE TACTILE SENSATION ON SKIN
ftw|DECEPTION/BEGUILEMENT/DELUSION
gţr|CISTERN|service of cistern|use of cistern|non-use of cistern
gzň|SEWER|service of sewer|use of sewer|non-use of sewer
jbv|LENDING⬌BORROWING|(be) the state/act of a lending⬌borrowing relationship|(be) the state/act of lending|(be) the state/act of borrowing
jbř|OFFERING CREDIT⬌BEING IN/PAYING OFF DEBT|(be) the state/act of a offering credit⬌being in/paying off debt relationship|(be) the state/act of offering credit|(be) the state/act of being in/paying off debt
jby|NUMBNESS/“PINS & NEEDLES” FEELING
jdw|AFFECTIVE TACTILE REACTIONS
jgr|DISAPPOINTMENT
jkç|CONTEMPLATION|feel contemplative|feel pensive|feel brooding
jkţ|WORKBENCH/COUNTERTOP/DRAWING BOARD|(to be) a workbench|(to be) a countertop|(to be) a drawing board
jmw|HAND AS FLAT RIGID “BLADE”
jmy|CLOSED FIST
jnw|ATTRIBUTION/CREDIT/PUBLIC RECOGNITION/AWARD/PRIZE
jţr|ARTIFICIAL FOUNTAIN|service of fountain|use of fountain|non-use of fountain
kçm|BALCONY/LANDING/MEZZANINE/LOFT|balcony (outdoors)|landing (at the end of a stretch of stairs)|mezzanine/loft (partial floor/story above a full one)
kfl|SEA ANEMONE|sea anemone (Actiniarian)|zoanthid coral|tube-dwelling anemone (Penicillaria, Spirularia)
kfm|CTENOPHORE/PLACOZOAN|comb jelly, Venus girdle (Tentaculate)|beroid/cigar comb jelly (genera Beröe, Neis)|placozoan (genera Trichoplax, Hoilungia, Polyplacotoma)
kfn|PARASITIC CNIDARIAN|polypodium|myxosporean myxozoan|saccosporid myxozoan (Malacosporean; genera Buddenbrockia, Tetracapsuloides)
kfp|HYDROZOAN|hydroid, polyp (Hydrozoan)|hydrozoan jelly, medusa (Hydrozoan)|siphonophore/colonial hydrozoan, Portuguese man o’war (Hydrozoan)
kfr|HEXACORALLINE CORAL|stony/hard coral (Scleractinia)|mushroom coral, elephant ear anemone (Corallimorpharia)|black/thorn coral (Antipatharia)
kfř|OCTOCORALLINE CORAL|sea pen, sea pansy (Pennatulacea)|soft coral, sea fan, sea whip, gorgonian (Alcyonaea)|soft coral (genera Heliopora, Nanipora)
kft|JELLYFISH|jellyfish (Coronamedusae, Discomedusae)|box jellyfish (Cubozoa)|stalked jellyfish (Stauromedusae)
kfw|PORIFERA (SEA SPONGE) 1|calcareous sponge (Calcarea)|glass sponge (Hexactinellid)|coralline sponge (Demosponge)
kfy|PORIFERA (SEA SPONGE) 2|spiculate sponge (Plakinid)|slime sponge, aspiculate sponge (genera Oscarella, Pseudocorticium)|n/a
khw|SEMI-CONSCIOUS RESPIRATORY REACTION|sigh|huff (of indignation)|puff/blow out breath (of relief)
ksn|POSITIVE OVERALL PHYSICAL STATE
ksw|BIFURCATION/MULTIFURCATION/BRANCHING
kšn|PLANT PART 3|leaf|flower|bud
kšt|CHAIR/STOOL/THRONE|(to be/sit in) a chair|(to be/sit on) a stool|(to be/rest on) an ottoman/footstool
kšw|PLANT PART 2|root|stem/stalk/shoot|branch/limb/twig
kth|FIRMAMENT/GROUND/FLOOR|ground/firmament|land surface|floor
ktl|AREA/AREAL FOOTPRINT/PLOT OF GROUND/PLOT OF LAND
lcw|FIXTURE|service of building fixture|use of building fixture|non-use of building fixture
lçl|COMPLEMENTARY RELATIONSHIP/INTERACTION|(be) a complementary interpersonal relationship/interaction|(be) the state/act/situation of the 'alpha' party of an interpersonal relationship/interaction|(be) the state/act/situation of the 'beta' party of an interpersonal relationship/interaction
lčř|TOILET/LOO|service of toilet/loo|use of toilet/loo|non-use of toilet/loo
ldn|GUM TISSUE/HARD PALATE
lḑř|ILLUSION/SYNAESTHESIA/HALLUCINATION
lgv|CARDIOGENIC SENSATION
lks|FOODSTUFF/BEVERAGE|food/beverage for consumption|preparing a food/beverage|sourcing/raising material for foodstuff
lkt|DISH/RECIPE FROM ANIMAL/PLANT PRODUCTS|dish made from animal/plant products|preparing a animal/plant product recipe|sourcing/raising animal/plant products for foodstuff
llh|UNEXPECTED/EXASPERATED BEWILDERMENT
lms|SWEET/FRAGRANT/RESINOUS
lpf|INTERIOR SURFACE TISSUES OF MOUTH
ltç|SUGGESTION/ADVICE/ PROFFER/RECOMMENDATION/PROPOSITION
lţn|PHYSICAL “HIGH”/ EUPHORIA/ALTERED  STATE OF
lvg|BERYLLIUM|beryllium|Be ion w/missing electron(s)|Be ion w/additional electron(s)
lvř|PROPRIOCEPTION/KINAESTHESIA (physical sense of bodily movement, position, coordination)
lxt|NITROGEN|nitrogen|N ion w/missing electron(s)|N ion w/additional electron(s)
lzr|SWAMP/MARSH/BOG/FEN/BAYOU/WETLANDS
lzw|ESTUARY/RIVER DELTA/FRESHWATER-SALTWATER TRANSITION ZONE
ļph|CONTEMPLATION OF THE WORLDS COMPLEXITY/ABSURDITY
ļpw|PLIANCY/DUCTILITY/SUPPLENESS/DEFORMABILITY/SPREADABILITY
ļty|FRUIT PUNCH
mbl|TAP/FAUCET/VALVE|service of faucet/valve|use of faucet/valve|non-use of faucet/valve
mbř|ABNORMAL VESTIBULAR-PROPRIOCEPTIVE SENSATION
mbw|ABSORPTION/SUCTION
mçt|EXAMPLE/EXEMPLAR/PRECEDENT/ARCHETYPE
mgř|INTEROCEPTION
mll|IRONIC RELIEF/IRONIC SURPRISE  (Specification pattern for this root follows that of the Emotion roots)
mmh|PHYSICAL/SENSORY PLEASURE
mmž|IRONY/SARCASM
mpr|TERMINATION/FINISH/END/FINALITY/COMPLETION
msp|SYLVIOID BIRD 1|lark, skylark, sparrow-lark, hoopoe-lark (Alaudid)|nicator (genus Nicator)|bearded reedling/parrotbill/tit (genus Panurus)
msř|RESPIRATORY DIFFICULTY
mst|PASSERID 1|berrypecker (genera Melanocharis, Rhamphocharis)|longbill (genera Toxorhamphus, Oedistoma)|satinbird (genera Cnemophilus, Loboparadisea)
mtr|HEAD COVERING/HAT/HELMET
mty|CABINET|(to be/store in) a cabinet|(to be/display in) a display case|(to be/store in) a hutch/specialty cabinet
mţr|WATER-BASED WEATHER PHENOMENON
ndk|LIST/SERIES/FILE
ndř|VESTIBULAR SENSATION i.e., physical sense of bodily balance and spatial orientation
ngr|SEMI-CONSCIOUS ORAL-NASAL SOUND/ACTION
nkl|BED/SOFA BED/CHAISE LONGUE|(to be/sit/lie on) a bed|(to be/sit/lie on) a sofa bed|(to be/sit/lie on) a chaise longue
nky|PUNGENT/FUNKY/PUTRID/STINKY
nsb|DOVE|dove (Turturini, Claravinae, Phabini)|quail-dove, zenaida dove (Zenaidini)|cuckoo-dove (genera Reinwardtoena, Turacoena, Macropygia)
nsd|PALEOGNATH 1|ostrich (genus Struthio)|rhea (genus Rhea)|emu (genus Dromaius)
nsf|CELEBRITY⬌FAN
nsg|DUCK 1|dabbling duck, mallard, teal, shoveler, pintail, widgeon, gadwall, Asian/Madagascar/East African/Pacific duck (Anatine)|seaduck, merganser, smew, eider, scoter, goldeneye, bufflehead, long-tailed duck, harlequin duck (Merginine)|black-headed duck, masked duck, stiff-tailed duck (genera Heteronetta, Nomonyx, Oxyura)
nsk|TURDID (THRUSH/BLACKBIRD)|thrush, Old World blackbird, ouzel, fieldfare, redwing, American robin (genus Turdus)|bluebird (genus Sialia)|grandala, solitaire, cochoa, fruithunter (Turdid)
nsp|CHICKEN/TURKEY|chicken (Gallus gallus domesticus)|junglefowl (genus Gallus)|turkey, wild turkey, ocellated turkey (genus Meleagris)
nst|CORVINE (CROW)|crow, raven, rook (genus Corvus)|jackdaw (genus Coloeus)|nutcracker (genus Nucifraga)
nšk|MIRADORNITHID/PEDIONOMID|flamingo (Phoenicopterid)|grebe (Podicipedid)|n/a
nšp|EMBERIZOID BIRD 1|American sparrow, towhee, lark bunting, ground sparrow, junco (Passerellid)|bunting, reed bunting, yellowhammer (genus Emberiza)|rosy thrush-tanager (genus Rhondinocichla)
nšt|CHARADRIIFORM 1|plover (genera Pluvialis, Pluvianus, Charadrius, Thinornis, Phegornis)|ibisbill (genus Ibidorhyncha)|dotterel, wrybill, lapwing (genera Orepholus, Eurodromias, Peltohyas, Erythrogonus, Anarhynchus, Vanellus)
ntn|PREDATION⬌PREY|(to be) the state/act of a predation/prey relationship|(to be) a state/act of predation|(to be) the act/state of being stalked/preyed upon
nxw|AMPHIBIAN
nžt|PRUNUS TREE/SHRUB  1 (subgenus P. Amygdalus)
ňļy|LAMINID|llama, guanaco (genus Lama)|alpaca (Vicugna pacos)|vicuña (Vicugna vicugna)
ňňs|SOLICITATION/SUPPLICATION/IMPLORE/BESEECH/ENTREATY/APPEAL
ňpw|LESS COMMON HUMAN BODILY POSITIONS
ňsb|CISTICOLID (AFRICAN/ASIAN WARBLER) 1|cisticola (genus Cisticola)|jery (genus Neomixis)|African/Asian warbler (genera Oreophilais, Incana, Drymocichla, Spiloptila, Phyllolais, Malcorus, Hypergerus, Eminia, Euryptila, Bathmocercus, Sceopmycter, Artisomus, Poliolais)
ňsd|VULTURE/CONDOR|New World vulture (genera Cathartes, Coragyps, Sarcoramphus)|condor (genera Gymnogyps, Vultur)|Old World vulture (Aegypiine, Gypaetine)
ňsg|CISTICOLID (AFRICAN/ASIAN WARBLER) 3|miniature babbler (genus Micromacronus)|green longtail (genus Urolais)|wren-warbler (genus Calamonastes)
ňsk|ORIOLID|oriole (genus Oriolus)|figbird (genus Sphecotheres)|pitohui (genus Pitohui)
ňsp|PICID (WOODPECKER)|woodpecker (Picine)|piculet (genera Picumnus, Sasia, Nesoctites)|wryneck (genus Jynx)
ňst|MENUROID BIRD|n/a|lyrebird (genus Menura)|scrubbird (genus Atrichornis)
ňšt|FRINGILLID (FINCH)|chaffinch, brambling (genus Fringilla)|grosbeak, hawfinch, bullfinch, rosefinch, drepanid/honeycreeper, greenfinch, twite, linnet, redpoll, crossbill, serin, mountain finch, desert finch, African canary, goldfinch, siskin (Carduelline)|euphonia, chlorophonia
ňzd|SULFUR|sulfur|S ion w/missing electron(s)|S ion w/additional electron(s)
ňžw|REGULARITY/CLASSIFICATION/ASSORTMENT|being/making regular|being in/making a classification|being in/making an assortment
pçk|HYDROGEN|hydrogen|H ion w/missing electron(s)|H ion w/additional electron(s)
pfn|TWITCHING/FLUTTERING/TREMBLING
pkl|FIN/FLIPPER
pļļ|HUMOR/WIT/JEST
pļm|ZIRCONIUM|zirconium|Zr ion w/missing electron(s)|Zr ion w/additional electron(s)
pļn|HAFNIUM|hafnium|Hf ion w/missing electron(s)|Hf ion w/additional electron(s)
pļň|RUTHERFORDIUM|rutherfordium|Rf ion w/missing electron(s)|Rf ion w/additional electron(s)
pļw|TITANIUM|titanium|Ti ion w/missing electron(s)|Ti ion w/additional electron(s)
psc|BERYCIFORM FISH 1|alfonsino (genus Beryx)|nannygal (genus Centroberyx)|shellskin alfonsino (genus Ostracoberyx)
psč|BERYCIFORM FISH 2|flabby whalefish, tapetail, hairyfish (Cetomimid)|redmouth whalefish (genus Rondeletia)|velvet whalefish (genus Barbourisia)
psk|SALMON/TROUT/CHAR|Pacific salmon/trout (genus Oncorhynchus)|Atlantic salmon, Brown trout (genus Salmo)|char, long-finned char (genera Salvelinus, Salvethymus)
psp|GADID FISH 1|cod (genus Gadus)|haddock (genus Melanogrammus)|whiting/merling (genus Merlangius)
psř|HAVE AN ITCH; TO ITCH
pst|CLUPEIFORM FISH|anchovy (Engraulid)|herring, sprat, sardine, shad (Clupeid)|denticle herring, longfin herring, wolf herring, round herring (Clupeiform)
psw|RESPIRATION
pšč|BERYCIFORM FISH 3|ridgehead/bigscale (Melamphaid)|gibberfish (genus Gibberichthys)|pricklefish (Stephanoberycid, Hispidoberycid)
pšk|PLEURONECTID FISH (RIGHTEYE FLOUNDER) 1|Atlantic halibut (Hippoglossus hippoglossus)|Pacific halibut (Hippoglossus stenolepis)|Greenland halibut/Greenland turbot (genus Reinhardtius)
pšp|PERCID FISH|perch, ruffe, schraetzer, percarina (Percine)|darter (Etheostomatine)|sculpin-perch, asprete, walleye, pike-perch, Zander, Sauger, streber, zingel (Luciopercine)
pšt|ACHIRID FISH (AMERICAN SOLE)|drab, plainfin, brown, lined, Mazatlan, American, or network sole (genus Achirus)|fringed, freshwater, spotted-in, scrawled, spotted-cheek, or slipper sole, hogchoker (genus Trinectes)|unusual American sole (genera Apionichthys, Catathyridium, Gymnachirus, Hypoclinemus, Pnictes)
pţt|FURNITURE/FURNISHING/APPLIANCE|(to be/furnish w/) a piece of furniture|(to be/decorate w/) a piece of furniture|(to be/fit out w/) a functional appliance
rçp|BODILY POSE/IN SITU MOVEMENT/DANCE|(to be/manifest) a bodily pose|(to be) in situ movement of body/limbs|(to be) dancing
rdw|BUILDING CONSTRUCTION|constructing/being in a building|constructing a commercial building|constructing a storage/workshop/studio/misc. building
rgy|VEGETAL/PIQUANT/MUSTY
rhw|OCCUPANCY/TENANCY/RESIDENCY|occupancy|tenancy|residency
rks|SPLIT IN HALF/DIVIDE INTO PARTS/SPLIT OFF A PIECE
rrc|SELF/IDENTITY/OPINION/PERSONAL BELIEF/PERSONALITY
rrf|BAY CAT FELINES (genera Catopuma, Pardofelis)
rsň|TANTALUM|tantalum|Ta ion w/missing electron(s)|Ta ion w/additional electron(s)
rtn|FIDDLE/PLAY ABSENT-MINDEDLY
rtň|VANADIUM|vanadium|V ion w/missing electron(s)|V ion w/additional electron(s)
rzg|CHEMICAL/BURNT/ACRID
řcc|ERBIUM|erbium|Er ion w/missing electron(s)|Er ion w/additional electron(s)
řcč|YTTERBIUM|ytterbium|Yb ion w/missing electron(s)|Yb ion w/additional electron(s)
řcp|LANTHANUM|lanthanum|La ion w/missing electron(s)|La ion w/additional electron(s)
řčř|URINAL|service of urinal|use of urinal|non-use of urinal
řtl|RUBUS PLANT HYBRID 2|marionberry plant|youngberry plant|olallieberry plant
řtw|RUBUS PLANT 2|cloudberry plant|salmonberry plant|thimbleberry plant
řty|RUBUS PLANT HYBRID 1|loganberry plant|boysenberry plant|tayberry plant
řxm|GASTRO-INTESTINAL PAROXYSM 2|feel need to vomit (CPT=vomit)|feel need to fart (CPT=fart)|feel stomach/intestinal cramp
sfř|SOUR FLAVOR
sgl|IRON|iron|Fe ion w/missing electron(s)|Fe ion w/additional electron(s)
sgv|HASSIUM|hassium|Hs ion w/missing electron(s)|Hs ion w/additional electron(s)
sgw|RUTHENIUM|ruthenium|Ru ion w/missing electron(s)|Ru ion w/additional electron(s)
sgy|OSMIUM|osmium|Os ion w/missing electron(s)|Os ion w/additional electron(s)
skf|TABLE/SHELF/PLATFORM|(to be/use) a table|(to be/use) a shelf|(to be/use) a platform/stage/board for a specialized function
sky|HUMBLE LIFESTANCE
stn|NERVOUS HABIT
stw|DISSOCIATIVE STATE
sxw|CRIMINAL⬌VICTIM|(be) the state/act of a criminal⬌victim relationship|(be) the state/act of a criminal|(be) the state/act of a victim of a crime
šfw|DÉJÀ VU/JAMAIS VU
škl|PSYCHIATRIC TREATMENT/MANIPULATION
škr|CHROMIUM|chromium|Cr ion w/missing electron(s)|Cr ion w/additional electron(s)
škř|SEABORGIUM|seaborgium|Sg ion w/missing electron(s)|Sg ion w/additional electron(s)
škw|MOLYBDENUM|molybdenum|Mo ion w/missing electron(s)|Mo ion w/additional electron(s)
šky|TUNGSTEN|tungsten|W ion w/missing electron(s)|W ion w/additional electron(s)
špl|GALLIUM|gallium|Ga ion w/missing electron(s)|Ga ion w/additional electron(s)
špr|INDIUM|indium|In ion w/missing electron(s)|In ion w/additional electron(s)
špř|THALLIUM|thallium|Tl ion w/missing electron(s)|Tl ion w/additional electron(s)
špš|NIHONIUM|nihonium|Nh ion w/missing electron(s)|Nh ion w/additional electron(s)
špw|BORON|boron|B ion w/missing electron(s)|B ion w/additional electron(s)
špy|ALUMINUM|aluminum|Al ion w/missing electron(s)|Al ion w/additional electron(s)
tfř|FEEL INTEROCEPTIVE BODILY MOVEMENT
tkf|MECHANICAL JOINT/PIVOT POINT FOR KINEMATIC PAIR
tkl|PHYSICAL STATE OF MATTER
tkř|NEURO-MUSCULAR REACTION
tkw|ATTENDANCE/PRESENCE
tļn|MANGANESE|manganese|Mn ion w/missing electron(s)|Mn ion w/additional electron(s)
tļň|RHENIUM|rhenium|Re ion w/missing electron(s)|Re ion w/additional electron(s)
tnw|JAILING⬌PRISONER|(be) the state/act of a jailing⬌prisoner relationship|(be) the state/act of jailing|(be) the state/act of a prisoner
tny|ENSLAVING⬌SLAVE|(be) the state/act of a enslaving⬌slave relationship|(be) the state/act of enslavement|(be) the state/act of a slave
tpr|CONSISTENCY/MALLEABILITY/FLEXIBILITY/PLASTICITY/RHEOLOGICAL PHENOMENON
tpř|HABITUAL ORAL ACTIONS
tpw|SPRINGINESS/BUOYANCY/RECOIL
ttļ|WALL/PARTITION/BARRIER|wall as boundary of inclosure|barrier as defense against visibility/intrusion|wall/partition as building component/architectural structure
ţdr|BEER
ţgl|FERMENTED ALCOHOLIC BEVERAGE (other than fruit-based wine or beer, e.g., mead, vegetable-based liquor, nut-based liqueurs, etc.)
ţgr|FERMENTED FOODSTUFF
ţgw|DECOCTION/INFUSION
ţky|WINDOW/VIEWING APERTURE|aperture/window for seeing other side|window for letting in light|partition/window for limited physical access
ţlw|SCREEN|(to be/place) screen partitioning (between two areas of space)|(to be/use) screen filtering (light, water, air)|(to be/display) screen for projection (of an image/shadow)
ţpç|OYSTER|oyster, foam/honeycomb oyster (Ostreoid)|hammer, pearl, tree, winged, or feather oyster, pulvinitid (Pterioid)|dimyarian oyster (Dimyid)
ţpf|MUSSEL/SCALLOP|freshwater mussel (Unionoid)|saltwater mussel (Mytiloid)|scallop, glass scallop, mud scallop (Pectinid, Propeamussid, Entoliid)
ţpl|SLUG|slug|sea slug/nudibranch|sea hare (Anaspid)
ţpļ|SQUID/CUTTLEFISH|squid (Myopsid, Oegopsid)|bobtail squid, ram’s horn squid (Sepiolid, Spirulid)|cuttlefish (Sepiadariid)
ţpr|CLAM|clam|cockle (mollusc)|file shell (Limid)
ţpř|MYID/HIATELLID|soft-shell clam (Myid)|geoduck (Hiatellid)|shipworm (genus Teredo)
ţps|PTERIOMORPH 1|jingle shell/saddle oyster (Anomiid)|windowpane shell/windowpane oyster (Placunid)|pen shell (Pinnid)
ţpš|PTERIOMORPH 2|ark shell/ark clam/bittersweet (Arcid)|kittenpaw (genus Plicatula)|spiny oyster/thorny oyster (genus Spondylus)
ţpţ|OCTOPOD|octopus (Octopoda)|vampire squid (genus Vampyroteuthis)|argonaut/paper nautilus (genus Argonauta)
ţpw|SNAIL|terrestrial snail|sea snail/whelk|limpet
ţpy|DISTINCTIVE SEA SNAIL|abalone|conch (sea snail with pointed/spired/horned shell)|sea butterfly (Thecosome)
vbl|PIPE|service of pipe|use of pipe|non-use of pipe
vbw|LEFT+FRONT+BELOW (-X/+Y/-Z)|position left, in front & below|leftward, forward, & downward|area left, ahead, & below
vby|LEFT+FRONT+ABOVE (-X/+Y/+Z)|position left, in front, & above|leftward, forward & upward|area left, ahead, & above
vgw|LEFT+BEHIND+BELOW (-X/-Y/-Z)|position left, behind, & below|leftward, backward, & downward|area left, behind, & below
vgy|LEFT+BEHIND+ABOVE (-X/-Y/+Z)|position left, behind, & above|leftward, backward, & upward|area left, behind, & above
vsl|SEASONALLY-DETERMINED SOLAR EXPOSURE OR TEMPERATURE
vsm|AUTHOR⬌READER OF A WRITTEN WORK|(be) the state/act of an author⬌reader of a written work relationship|(be) the state/act of an author (relation w/reader)|(be) the state/act of a reader (relation w/author)
vsn|MUSIC COMPOSER⬌LISTENER|(be) the act/state of a music composer⬌listener relationship|(be) the state/act of a music composer (relation w/listener)|(be) the state/act of a music listener (relation w/composer)
vsw|PERFORMING⬌ATTENDING ARTS PERFORMANCE|(be) the state/act of an arts performer⬌attender relationship|(be) the state/act of an arts performer|(be) the state/act of attending an arts performance
vsy|VISUAL ARTS EXHIBITING⬌ATTENDER|(be) the state/act of a visual arts exhibition⬌attender relationship|(be) the state/act of a visual arts exhibitor|(be) the state/act of a visual arts exhibition attender
vtř|(to be) a drawer|(to be) a filing slot|(to be) a rack
vvt|TACT(FULNESS)/INGRATIATE/OBSEQUIOUSNESS/SYCOPHANCY
vzn|SPONTANEOUS SUSPICION OVER PERSONAL SPACE
xbl|LIQUID AS RESOURCE CONSUMED IN A PROCESS 1
xbr|LIQUID AS RESOURCE CONSUMED IN A PROCESS 2
xby|PARTS OF A BODILY JOINT
xdl|PLATINUM|platinum|Pt ion w/missing electron(s)|Pt ion w/additional electron(s)
xdr|DARMSTADTIUM|darmstadtium|Ds ion w/missing electron(s)|Ds ion w/additional electron(s)
xdw|NICKEL|nickel|Ni ion w/missing electron(s)|Ni ion w/additional electron(s)
xdy|PALLADIUM|palladium|Pd ion w/missing electron(s)|Pd ion w/additional electron(s)
xpw|HABITUAL ACTION
zhw|GRASS/STALK-LIKE PLANT
zkř|PARANORMAL EXPERIENCE
ztç|FERN-LIKE PLANT
zvl|SOUTH AMERICAN CERDOCYONINE FOX/DOG/WOLF|South American fox (genus Lycalopex)|bush dog (genus Speothos)|unusual South American cerdocyonine canine (e.g., genera Chrysocyon, Dusicyon, Cerdocyon, Atelocynus)
zvw|FOX|red fox (V. vulpes)|fox (genus Vulpes; species zerda, cana, chama, rueppellii, corsac, ferrilata, macrotis, lagopus)|bat-eared fox (genus Otocyon)
zvy|CANINE|African wolf, Asian wolf, jackal (genus Canis; species anthus, simensis, aureus, mesomelas, adustus)|dhole, Asiatic wild dog (genus Cuon)|African wild dog/painted wolf (genus Lycaon)
zvy|OTHER CANINES
ẓgř|INTERNAL BURNING/TINGLING/PRICKLY
ẓkţ|ELEPHANT SHREW/SENGI
ẓky|MODULATION OF ELECTROMAGNETIC WAVE FOR COMMUNICATION PURPOSES
ẓmw|FRAGILITY/BRITTLENESS/CRUMBLINESS
ẓtf|IRIDIUM|iridium|Ir ion w/missing electron(s)|Ir ion w/additional electron(s)
ẓtl|CRIMINAL ADJUDICATION
ẓtv|MEITNERIUM|meitnerium|Mt ion w/missing electron(s)|Mt ion w/additional electron(s)
ẓtw|COBALT|cobalt|Co ion w/missing electron(s)|Co ion w/additional electron(s)
ẓty|RHODIUM|rhodium|Rh ion w/missing electron(s)|Rh ion w/additional electron(s)
žbř|OSCILLATIVE AFFECTIVE BODILY STATE
žby|GUIDING ALONG/THROUGH A CHANNEL
ždw|INDUCED DISSOCIATIVE STATES
žjw|INVERTEBRATE OTHER THAN ARTHROPOD
žpf|FLEROVIUM|flerovium|Fl ion w/missing electron(s)|Fl ion w/additional electron(s)
žpl|CARBON|carbon|C ion w/missing electron(s)|C ion w/additional electron(s)
žpr|TIN|tin|Sn ion w/missing electron(s)|Sn ion w/additional electron(s)
žpř|LEAD (ELEMENT)|lead (element)|Pb ion w/missing electron(s)|Pb ion w/additional electron(s)
žpw|SILICON|silicon|Si ion w/missing electron(s)|Si ion w/additional electron(s)
žpy|GERMANIUM|germanium|Ge ion w/missing electron(s)|Ge ion w/additional electron(s)
žtļ|STAIRCASE/LADDER/PEDESTAL|staircase|ladder|pedestal/plinth/dais
žtw|POISONOUS, VENOMOUS, OR RADIOACTIVE SUBSTANCE
bzdl[e]|AGOUTI/ACOUCHI/PACA
bzdr|GUINEA PIG/CAVY/CAPYBARA
bzdy|OTHER SOUTH AMERICAN RODENTS
bzmr|DIPODIDS
bzmř|PLATACANTHOMYIDS
bztl|BROMINE|bromine|Br ion w/missing electron(s)|Br ion w/additional electron(s)
bztļ|TENNESSINE|tennessine|Ts ion w/missing electron(s)|Ts ion w/additional electron(s)
bztr|IODINE|iodine|I ion w/missing electron(s)|I ion w/additional electron(s)
bztř|ASTATINE|astatine|At ion w/missing electron(s)|At ion w/additional electron(s)
bztw|FLUORINE|fluorine|F ion w/missing electron(s)|F ion w/additional electron(s)
bzty|CHLORINE|chlorine|Cl ion w/missing electron(s)|Cl ion w/additional electron(s)
bzvl|OTHER RODENTS|(genus Calmyscus) mouse-like hamster|(genus Pedetes) springhare|(genus Petromus) dassie rat
bzvr|GERBILS/JIRDS/TATERILS|(genera Dipodillus, Pachyuromys, Desmodilliscus, Ammodillus, Gerbillus, Microdillus, Desmodillus, Gerbilliscus, Gerbillurus)
bzvř|ANOMALURINE SCALY-TAILED FLYING SQUIRRELS|genus Anomalurus)  scaly-tailed flying squirrel|(genus Idiurus) long-eared flying mouse,
bzvw|SPALACIDS|(genera Myospalax, Eospalax)  zokor|(genera Rhizomys, Cannomys, Tachyoryctes) bamboo rat (a.k.a., root rat),  African mole-rat|(genus
gzpf|RADON|radon|Rn ion w/missing electron(s)|Rn ion w/additional electron(s)
gzpl|ARGON|argon|Ar ion w/missing electron(s)|Ar ion w/additional electron(s)
gzpļ|OGANESSON|oganesson|Og ion w/missing electron(s)|Og ion w/additional electron(s)
gzpr|KRYPTON|krypton|Kr ion w/missing electron(s)|Kr ion w/additional electron(s)
gzpř|XENON|xenon|Xe ion w/missing electron(s)|Xe ion w/additional electron(s)
gzpw|HELIUM|helium|He ion w/missing electron(s)|He ion w/additional electron(s)
gzpy|NEON|neon|Ne ion w/missing electron(s)|Ne ion w/additional electron(s)
kštl|BENCH/COUCH/FUTON|(to be/sit on) a bench|(to be/sit on) a couch/sofa/divan|(to be/sit/lie on) a futon
ljňw|ROENTGENIUM|roentgenium|Rg ion w/missing electron(s)|Rg ion w/additional electron(s)
lksw|DISH/RECIPE FROM FISH/SEAFOOD|dish made from fish/seafood|preparing a fish/seafood recipe|sourcing/raising fish/seafood for foodstuff
lksl|DISH/RECIPE FROM MAMMALIAN FLESH|dish made from mammalian flesh|preparing a mammalian flesh recipe|sourcing/raising a mammal for foodstuff
lksm|DISH/RECIPE FROM EGGS|dish made from eggs|preparing an egg recipe|sourcing/obtaining an egg for foodstuff
lksr|DISH/RECIPE FROM CEREAL GRAINS|dish made from grains|preparing a grain recipe|growing/cultivating cereal grain for foodstuff
lktl|DISH/RECIPE FROM BEANS/LEGUMES|dish made from beans/legumes|preparing a bean/legume recipe|cultivating/growing beans/legumes for foodstuff
lktr|DISH/RECIPE FROM SEEDS/NUTS|dish made from seeds/nuts|preparing a seed/nut recipe|sourcing/growing seeds/nuts for foodstuff
lktř|DISH/RECIPE FROM PLANT LEAVES/SHOOTS|dish made from leaves/shoots|preparing a leaf/shoot recipe|sourcing/growing leaves/shoots for foodstuff
lktw|DISH/RECIPE FROM FRUIT|dish made from fruit|preparing a fruit recipe|cultivating/growing fruit for foodstuff
lkty|DISH/RECIPE FROM VEGETABLES|dish made from vegetables|preparing a vegetable recipe|cultivating/growing vegetables for foodstuff
lmzl|SEA CUCUMBER|sea cucumber (Holothuroid)|molpadiid sea cucumber|tentacled sea cucumber (Dendrochirotid, Elasipodid)
lmzr|SEA FLOWER|sea lily (Crinoid)|feather star (Comatulid)|sea daisy (genus Xyloplax)
lmzř|HEMICHORDATE|acorn worm (Enteropneust)|cephalodiscus|rhabdopleura
lmzv|XENACOELOMORPH|Xenoturbella|acoel (Acoelomorph)|nemertodermatid acoel
lmzw|SEA STAR/BRITTLE STAR/BASKET STAR|sea star, starfish (Asteroidea)|brittle star (Ophiurid)|basket star (Euryalid)
lmzy|SEA URCHIN/SAND DOLLAR|sea urchin (Echinoid)|sand dollar (Clypeasteroid)|heart urchin (Spantagoid)
lpsk|BOTHID FISH (LEFTEYE FLOUNDER) 1|scaldfish (genus Arnoglossus)|Pacific eyed, Guinean, Pacific leopard, mottled, flowery, St. Helena, eyed, wide-eyed, leopard, twospot, or Indo-Pacific oval flounder, Plate fish (genus Bothus)|blue, Kobe, broadbrow, or Lord Howe Island flounder (genus Crossorhombus)
lpsp|CARANGID FISH 1|leerfish/garrick (genus Lichia)|pompano (genus Trachinotus)|queenfish (genus Scomberoides)
lpst|MELANOTAENIID FISH (RAINBOWFISH)|rainbowfish (Melanotaenine)|Madagascar rainbowfish, Celebes rainbowfish (Bedotiine, Telmatherinine)|blue-eye (genera Kiunga, Pseudomugil, Scaturiginichthys)
lpšt|OPHIDIIFORM FISH|pearlfish (Carapid)|brotula, cusk-eel, false brotula, aphyonid (Ophidiid, Aphyonid, Parabrotulid)|viviparous brotula (Bythitid)
ltkf|MECHANICAL JOINT/PIVOT POINT FOR KINEMATIC PAIR
lţpç|GNATHIFER|thorny-headed/spiny-headed worm (Acanthocephala)|arrow worm (Chaetognath)|symbion (Cycliophoran)
lţpf|FLATWORM|tapeworm (cestode)|fluke (trematode)|flatworm, planarian (platyhelminth)
lţpl|MICROSPCOPIC ECDYSOZOAN|tardigrade/water bear (Tardigrada)|loriciferan|mud dragon/spiny crown worm (Kinorhynchan)
lţpļ|UNSUSUAL SPIRALIA|jaw worm (Gnathostomulid)|limnognathia (Micrognathozoan)|gastrotrich/hairyback
lţpr|PRIAPULID WORM|penis worm (genera Priapulus, Priapulosis)|tubiluchide penis worm (genus Tubilucus)|giant penis worm (genus Halicryptus)
lţpř|ROTIFER|rotifer (Eurotatoria)|monogonant rotifer|seisonid rotifer (genera Seison, Paraseison)
lţpţ|BRYOZOAN/ENTOPROCT|moss animal (Bryozoa/Ectoprocta)|entoproct/kamptozoan|n/a
lţps|ANNELID-RELATED ANIMAL 1|horseshoe worm (genera Phononis, Actinotrocha)|brachiopod|peanut worm (Sipuncula)
lţpš|ANNELID-RELATED ANIMAL 2|ribbon worm, proboscis worm (Nemertean)|myzostomid|dicyemid/rhombozoan
lţpw|ANNELID|earthworm|leech|unusual ringed/segmented worm
lţpy|NEMATODE|nematode/roundworm|horsehair/Gordian worm (Nematomorph)|velvet worm (Onychophore)
lvgl|STRONTIUM|strontium|Sr ion w/missing electron(s)|Sr ion w/additional electron(s)
lvgr|BARIUM|barium|Ba ion w/missing electron(s)|Ba ion w/additional electron(s)
lvgř|RADIUM|radium|Ra ion w/missing electron(s)|Ra ion w/additional electron(s)
lvgv|SCANDIUM|scandium|Sc ion w/missing electron(s)|Sc ion w/additional electron(s)
lvgw|MAGNESIUM|magnesium|Mg ion w/missing electron(s)|Mg ion w/additional electron(s)
lvgy|CALCIUM|calcium|Ca ion w/missing electron(s)|Ca ion w/additional electron(s)
lvgz|YTTRIUM|yttrium|Y ion w/missing electron(s)|Y ion w/additional electron(s)
lxtl|ANTIMONY|antimony|Sb ion w/missing electron(s)|Sb ion w/additional electron(s)
lxtr|BISMUTH|bismuth|Bi ion w/missing electron(s)|Bi ion w/additional electron(s)
lxtř|MOSCOVIUM|moscovium|Mc ion w/missing electron(s)|Mc ion w/additional electron(s)
lxtw|PHOSPHORUS|phosphorus|P ion w/missing electron(s)|P ion w/additional electron(s)
lxty|ARSENIC|arsenic|As ion w/missing electron(s)|As ion w/additional electron(s)
mskl|BUCEROTIFORM|hornbill, ground hornbill (Bucerotid, Bucorvid)|hoopoe, wood hoopoe (genera Phoenuculus, Upupa)|scimitarbill (genus Rhinopomastus)
mskw|OWL|owl, including screech, eared, horned, or eagle-owl (Strigid)|barn owl, grass owl, masked owl (genus Tyto)|bay owl (genus Phodilus)
msky|CORACIIMORPH|mousebird (genera Colius, Urocolius)|cuckoo roller/courol (genus Leptosomus)|trogon, quetzal (Trogonid)
mspç|SYLVIOID BIRD 7|Old World babbler, wren-, scimitar-, tit-, tawny-bellied, chestnutcapped, wedge-billed, or dark-fronted babbler (Timaliid)|babbler, grass babbler, fulvetta, wren-babbler, iliadopsis, grassbird (Pellorneid)|laughingthrush, babbler, cutia, crocia, barwing, minla, sibia, liocichla, babax (Leiothrichid)
mspf|HIRUNDIDS (SWALLOW/MARTIN)|swallow, cliff swallow (genera Hirundo, Cecropsis, Alopochelidon, Neochelidon, Atticora, Haplocheledon, Notiochelidon, Tachycineta, Cheramoeca, Petrochelidon)|martin, river martin, crag martin, house martin (genera Delichon, Progne, Ptyonoprogne, Riparia, Phedina, Pseudochelidon)|saw-wing (genus Psalidoprocne)
mspl|SYLVIOID BIRD 4|bulbul, greenbul, bristlebill, brownbul, leaflove (Pycnonotid)|bush warbler, stubtail, tesia, broad-billed warbler (Cettiid)|hylia (genera Hylia, Pholidornis)
mspr|SYLVIOID BIRD 5|Old World warbler, blackcap, whitethroat, parisoma (genus Sylvia)|myzornis, Abyssian catbird (genera Myzornis, Parphasma)|bushtit, tit-warbler (Aegithalid)
mspř|SYLVIOID BIRD 6|babbler, thrushbabbler, fulvetta (genera Myzornis, Pseudoalcippe, Horizorhinus, Lioptilus, Fulvetta, Chrysomma, Moupinia, Rhopophilus)|parrotbill (genera Conostoma, Cholornis, Suthora, Sinosuthora, Neosuthora, Chleuasicus, Psittiparus, Paradoxornis)|wrentit (genus Chamaea)
mspw|SYLVIOID BIRD 2|cupwing/wren-babbler (genus Pnoepyga)|reed warbler, swamp warbler, millerbird (genus Acrocephalus)|grass warbler, grassbird, bush warbler, grasshopper warbler, malia (Locustellid)
mspy|SYLVIOID BIRD 3|black-capped donacobius (genus Donacobius)|Madagascar warbler, yellowbrow, bernieria, wedge-tailed jery (Bernierid)|leaf warbler, chiffchaff (genus Phylloscopus)
mstf|CARDINALID (CARDINAL) 1|cardinal (genera Cardinalis, Gubernatrix)|grosbeak (genera Periporphyrus, Caryothraustes, Rhodothraupis, Cyanocompsa, Cyanoloxia, Pheucticus)|cardinalid tanager (genera Chlorothraupis, Habia, Piranga)
mstl|PAROID BIRD|fairy flycatcher, crested flycatcher, canary-flycatcher (Stenostirid)|hyliota (genus Hyliota)|penduline tit, verdin (Remizid)
mstr|PARID (TIT/TITMOUSE/CHICKADEE)|tit, chickadee (genus Parus, Melaniparus, Sittiparus, Pardaliparus, Periparus, Sylviparus, Cephalopyrus, Machlolophus, Melanochlora, Pseudopodoces, Cyanistes, Poecile)|titmouse (genus Baeolophus)|crested tit (genus Lophophanus)
mstř|MACROSPHENID (AFRICAN WARBLER)|longbill (genus Macrosphenus)|crombec (genus Sylvietta)|rockrunner, grass warbler, grassbird (genera Achaetops, Sphenoeacus, Cryptillas, Melocichla)
mstv|CARDINALID (CARDINAL) 2|North American bunting (genus Passerina)|dickcissel, seedeater (genera Spiza, Amaurospiza)|chat (genus Granatellus)
mstw|PASSERID 2|stitchbird/hihi (genus Notiomystis)|Austrolasian robin, flyrobin (Petroicid)|kokako, saddleback, huia (genera Callaeas, Philestumus, Heteralocha)
msty|EUPETOID BIRD|rockfowl/bald crow (genus Picathartes)|rockjumper (genus Chaetops)|railbabbler (genus Eupetes)
nļny|CITRUS HYBRID  3
nsbl|GRUIFORM|crane (genera Grus, Belearica)|limpkin/carrao/courlan/crying bird (genus Aramus)|trumpeter (genus Psophia)
nsbr|RALLID (RAIL) 1|rail, weka (genera Rallus, Lewinia, Gallirallus, Rallicula, Dryolimnas, Gymnocrex, Hypotaenidia, Pardirallus, Aramides, Himantornis, Megacrex, Coturnicops)|crake, sora, bush-hen, watercock (genus Crex, Anurolimnas, Mustelirallus, Amaurolimnas, Porzana, Aenigmatolimnus, Amaurornis, Gallicrex, Rallina, Myrcropygia, Laterallus, Mundia, Hapalocrex)|moorhen, marsh hen, gallinule, nativehen, waterhen/swamp chicken (genera Gallinula, Paragallinula, Porphyrio, Tribonyx)
nsbř|RALLID (RAIL) 2|grey-throated rail (genus Canirallus)|flufftail (genus Sarothrura)|Rouget’s rail (genus Rougetius)
nsbv|HELIORNITHID (FINFOOT)|masked/Asian finfoot (genus Heliopais)|African finfoot (genus Podica)|sungrebe (genus Heliornis)
nsbw|PIGEON|pigeon (Raphini, Treronini, Ptilinopini)|American pigeon (genus Patagioenas)|phabine pigeon (genera Ocyphaps, Petrophassa, Leucosarcia)
nsby|UNUSUAL COLUMBIFORM BIRD|(genera Monias, Mesitornis) mesite|(Pteroclids) sandgrouse|n/a
nsdl|CRACID (GUAN/CURASSOW)|guan, chachalaca (Cracid)|horned guan (genus Oreophasis)|curassow (Cracinae)
nsdr|ODONTOPHORID/NUMIDID (NEW WORLD QUAIL/GUINEAFOWL)|New World quail (Odontophorine)|stone partridge, Nahan’s partridge (genus Ptilopachus)|guineafowl (Numidid)
nsdř|LAROID (GULL/TERN/NODDY/SKIMMER)|gull/seagull, kittiwake (Larine)|tern (Sternine, Gygine)|noddy, skimmer (genera Anous, Rynchops)
nsdv|TROCHILID (HUMMINGBIRD)|hummingbird (Trochiline)|hermit, sicklebill, barbthroat (Phaethornithine)|n/a
nsdw|PALEOGNATH 2|cassowary (genus Casuarius)|kiwi bird (Agenus Apteryx)|tinamou (genus Tinamus)
nsdy|MEGAPODIID (BRUSHTURKEY/SCRUBFOWL)|brushturkey (genera Talegalla, Alectura, Aepypodius)|malleefowl (genus Leipoa)|scrubfowl, maleo, megapode (genera Macrocephalon, Eulipoa, Megapodius)
nsgl|TADORNINE (SHELDUCK/SHELDGOOSE)|blue, torrent, pink-eared, Mandarin, wood, Muscovy, maned, or knob-billed duck, shelduck, ringed teal, Salvadorini’s teal (genera Tadorna, Radjah, Hymenolaimus, Merganetta, Malacorhynchus, Aix, Carina, callonetta, Chenonetta, Salvadorina, Sarkidiornis)|Egyptian, Orinoco, Andean, blue-winged, or spur-winged goose, sheldgoose (genera Alopochen, Neochen, Chloephaga, Cyanochen, Plectropterus)|diving duck, pochard, scaup, canvasback, marbled teal (genera Aythya, Netta, Marmaronetta)
nsgr|SWAN|swan (genus Cygnus)|black-and-yellow-billed swan (genus Olor)|coscoroba swan (genus Coscoroba)
nsgř|ANSERIFORM|screamer (genera Anhima, Chauna)|magpie goose (genus Anseranas)|pygmy goose (genus Nettapus)
nsgv|APODID (SWIFT/TREESWIFT)|swift, palm swift, swallow-tail swift, swiftlet (Cypseloidini, Apodini, Collocalliini)|needletail, spinetail, spine-tailed swift (Chaeturini)|treeswift/crested swift (genus Hemiprocne)
nsgw|DUCK 2|whistling duck, white-backed duck (genera Dendrocygna, Thalassornis)|freckled duck (genus Stictonetta)|steamer duck (genus Tachyeres)
nsgy|GOOSE|goose (genus Anser)|black, Canada, barnacle, or cackling goose, nene, brant (genus Branta)|Cape Barren goose (genus Cereopsis)
nskf|SAXICOLINE 4|whistling thrush (genus Myophonus)|rock thrush (genus Monticola)|n/a
nskl|SAXICOLINE 1|nightingale, thrush nightingale, redstart, bluethroat (genus Luscinia)|shortwing (genera Heinrichia, Heteroxenicus, Brachypteryx)|blue robin, bush robin, bluetail, blue-fronted robin (genera Irania, Larvivora, Vauriella, Myiomela, Tarsiger, Cinclidium)
nskr|SAXICOLINE 2|chat, stonechat, cliff chat, moorland chat (genera Saxicola, Campicoloides, Pinarochroa, Thamnolaea, Emarginata, Myrmecocichla, Pinarornis, Namibornis)|redstart (genus Phoenicurus)|wheatear (genus Oenanthe)
nskř|SAXICOLINE 3|rubythroat, firethroat, blackthroat (genus Calliope)|forktail (genus Enicurus)|flycatcher, pygmy flycatcher (genera Ficedula, Muscicapella, Humblotia)
nskw|ERITHACINE 1|European robin/robin redbreast (genus Erithacus)|alethe (genus Chamaetylas)|robin-chat, cave chat, ground robin (genera Cossypha, Cossyphicula)
nsky|ERITHACINE 2|forest robin, robin-chat (genera Swynnertonia, Pogonocichla, Stiphromis)|akalat (genus Sheppardia)|palm thrush (genus Cichladusa)
nspç|TETRAONINES (GROUSE)|grouse, capercaillie (genera Falcipennis, Dendragapus, Tetrao, Tetrastes, Bonasa, Centrocercus)|ptarmigan (genus Lagopus)|prairie grouse, prairie chicken (genus Tympanuchus)
nspf|PHASIANINE (PHEASANT) 4|ruffed pheasant, golden pheasant (genus Chrysolophus)|eared pheasant (genus Crossoptilon)|monal (genus Lophophorus)
nspl|PHASIANINE (PHEASANT) 1|pheasant (genus Phasianus)|horned pheasant, tragopan (genus Tragopan)|blood pheasant (genus Ithaginis)
nspr|PHASIANINE (PHEASANT) 2|peafowl/peacock/peahen (genera Pavo, Afropavo)|peacock-pheasant (genus Polyplectron)|long-tailed pheasant (genus Syrmaticus)
nspř|PHASIANINE (PHEASANT) 3|great argus (genus Argusianus)|crested argus (genus Rheinardia)|cheer/Wallich’s pheasant (genus Catreus)
nspv|PHASIANINE (PHEASANT) 5|gallopheasant, fireback (genus Lophura)|koklass (genus Pucrasia)|n/a
nspw|TETRAOGALLINE (PARTRIDGE/QUAIL)|quail (genera Coturnix, Anurophasis, Synoicus, Excalfactoria, Ophrysia, Perdicula)|(Old World) partridge (genera Ammoperdix, Margaroperdix, Alectoris)|snowcock (genus Tetraogallus)
nspy|PARTRIDGE-LIKE BIRD|Asiatic/jungle/wood partridge (Rolluline)|francolin, spurfowl (genera Pternistis, Dendroperdix, Francolinus, Galloperdix, Peliperdix, Scleroptila)|partridge, monal-partridge (genera Arborophila, Bambusicola, Haematortyx, Lerwa, Perdix, Tetraophasis, Tropicoperdix)
nstç|PARADISAEID (BIRD-OF-PARADISE) 1|bird-of-paradise (genera Paradisaea, Pteridophora, Semioptera, Seleucidis, Cicinnurus, Paradisornis)|sicklebill (genera Epimachus, Drepanornis)|riflebird, superb bird-of-paradise (genera Lophorina)
nstf|PARADISAEID (BIRD-OF-PARADISE) 2|manucode (genera Manucodia, Phonygammus)|astrapia (genus Astrapia)|parotia (genus Parotia)
nstl|CORVID 3|jay, blue-jay, Steller’s jay (genera Cyanocorax, Cyanocitta, Cyanolyca)|brown jay (genus Psilorhinus)|magpie-jay (genus Calocitta)
nstm|CORVOID 1|shrike (Laniid)|monarch, crested flycatcher, paradise flycatcher (Terpsiphonine)|monarch, shrikebill, magpie-lark, torrent-lark, broad-billed flycatcher, ‘elepaio (Monarchine)
nstn|CORVOID 2|drongo, balicassiao (genus Dicrurus)|blue-caped ifrit (genus Ifrita)|melampitta (genus Melampitta)
nstň|CORCORACID (MUDNESTER)|white-winged chough (genus Corcorax)|apostlebird (genus Struthidea)|n/a
nstr|CORVID 4|scrub-jay, pinyon jay (genera Aphelocoma, Gymnorhinus)|Canada jay, Siberian jay, Sichuan jay (genus Perisoreus)|chough (genus Pyrrhocorax)
nstř|RHIPIDURID|fantail, wagtail (genus Rhipidura)|silktail (genus Lamprolia)|drongo fantail/pygmy drongo (genus Chaetorhynchus)
nstv|PARADISAEID (BIRD-OF-PARADISE) 3|paradise-crow (genus Lycocorax)|paradigalla (genus Paradigalla)|n/a
nstw|CORVID 1|magpie (genus Pica, Cyanopica, Cissa, Urocissa)|Old World jay (genus Garrulus)|treepie (genera Dendrocitta, Crypsirina, Temnurus, Platysmurus)
nsty|CORVID 2|ground jay/chough (genus Podoces)|piacpiac (genus Ptilostomus)|bush crow (genus Zavattariornis)
nškç|PELECANIFORM|pelican (genus Pelecanus)|hamerkop (genus Scopus)|shoebill/whalehead (genus Balaeniceps)
nškf|ARDEID (HERON/EGRET/BITTERN)|heron (Ardeine, Tigriornithine)|egret, cattle egret (genera Egretta, Bubulcus)|bittern (Botaurine)
nškl|PROCELLARIID (PETREL/PRION/SHEARWATER)|petrel, fulmar (genera Macronectes, Fulmarus, thalassoica, Daption, Pagodroma, Pterodroma)|prion (genera Pachyptila, Halobaena)|shearwater (genera Calonectris, Puffinus, Ardenna, Bulweria, Pseudobulweria, Lugensa, Procellaria)
nškm|SULIFORM (BOOBY/GANNET/FRIGATEBIRD) 1|booby (genera Sula, Papasula)|gannet (genus Morus)|frigatebird (genus Fregata)
nškn|SULIFORM (CORMORANT/DARTER) 2|cormorant, shag (genera Phalacrocorax, Microcarbo)|blue-eyed shag (genus Leucocarbo)|darter, snakebird, water turkey (genus Anhinga)
nškr|SPHENISCID (PENGUIN)|king penguin, emperor penguin (genus Aptenodytes)|crested, rockhopper, macaroni, royal, or fiordland penguin (genus Eudyptes)|Megellanic, Humboldt, Galápagos, African, banded, fairy, gentoo, Adélie, chinstrap, rump-legged/brush-tailed, yellow-eyed, or little penguin (genera Spheniscus, Pygoscelis, Megadyptes, Eudyptula)
nškř|CICONIID (STORK)|stork, adjutant (genera Mycteria, Ciconia, Ephippiorhynchus, Leptoptilos)|openbill (genus Anastomus)|jabiru (genus Jabiru)
nškţ|THRESKORNITHID (IBIS/SPOONBILL)|ibis (Threskornithine)|spoonbill (genus Platalea)|n/a
nškw|EURYPYGIMORPH|tropicbird (genus Phaethon)|sunbittern (genus Eurypyga)|kagu (genus Rhynochetos)
nšky|PROCELLARIFORM (TUBENOSE)|loon/diver (genus Gavia)|albatross, mollymawk (Diomedeids)|storm petrel (Hydrobatid, Oceanitid)
nšpf|THRAUPID (TANAGER) 3|grass-finch, pampa-finch (genera Emberizoides, Embernagra)|hemispingus (genus Hemispingus)|pardusco (genus Nephelornis)
nšpl|EMBERIZOID BIRD 4|micropspingid tanager (genera Mitrospingus, Orthogonys, Lamprospiza)|chat-tanager (genus Calyptophilus)|Puerto Rican tanager (genus Nesospingus)
nšpr|THRAUPID (TANAGER) 1|tanager, tanager-finch, conebill, flowerpiercer|bullfinch, orangequit, grassquit, warbler-finch, ground finch, tree finch, bananaquit (Tholospiza finch-like tanager)|mountain tanager (genera Cyanicterus, Bangsia, Buthraupis, Cnemathraupis, Chloromis, Wetmorethraupis, Anisognathus, Dubusia, Pseudosaltator)
nšpř|THRAUPID (TANAGER) 2|honeycreeper (genera Tersina, Cyanerpes, Chlorophanes, Iridophanes)|dacnis (genus Dacnis)|seedeater, seed-finch (genera Sporophila, Dolospingus, Oryzoburus)
nšpv|THRAUPID (TANAGER) 4|plushcap (genus Catamblyrhynchus)|Inca finch (genus Incaspiza)|saltator, many-colored Chaco finch (genera Saltator, Saltatricula)
nšpw|EMBERIZOID BIRD 2|tanager, white-winged warbler, green-tailed warbler (genera Phaenicophilus, Xenoligea, Microligea)|wrenthrush (genus Zeledonia)|Cuban warbler (genus Teretistris)
nšpy|EMBERIZOID BIRD 3|New World warbler, wood warbler, oven bird, waterthrush, yellowthroat, whitestart, parula, redstart (Parulid)|yellow-breasted chat (genus Icteria)|spindalis (genus Spindalis)
nštç|JACANID|jacana|lotusbird/lilytrotter/comb-crested jacana (genus Irediparra)|n/a
nštf|THINOCOROID|painted-snipe (genera Rostratula, Nycticryphes)|seedsnipe (genera Attagis, Thinocorus)|plains-wanderer (genus Pedionomus)
nštl|SCOLOPACIDS (SANDPIPER) 1|sandpiper, stint/peep, knot, sanderling, dunlin, ruff, surfbird (genera Calidris, Bartramia, Actitis, Xenus, Prosobonia)|curlew, whimbrel (genus Numenius)|godwit (genus Limosa)
nštm|ALCOID (SKUA/PUFFIN/AUKLET)|skua, jaeger (genus Stercorarius)|puffin, rhinoceros puffin (genera Fratercula, Cerorhinca)|auklet (genera Aethia, Ptychoramphus)
nštn|ALCINE (MURRE/GUILLEMOT/AUK)|murrelet (genera Brachyramphus, Synthliboramphus)|guillemot, murre/turr (genera Cepphus, Uria)|dovekie/little auk, razorbill/lesser auk (genera Alle, Alca)
nštr|SCOLOPACIDS (SANDPIPER) 2|turnstone (genus Arenaria)|phalarope (genus Phalaropus)|tattler, yellowlegs, shank (genus Tringa)
nštř|SCOLOPACINE (SNIPE)|snipe, jacksnipe (genera Gallinago, Coenocorypha, Lymnocryptes)|dowitcher (genus Limnodromus)|woodcock (genus Scolopax)
nštv|TURNICID/GLAREOLOID|buttonquail, quail-plover (genera Turnix, Ortyxelos)|crab-plover (genus Dromas)|pratincole, courser (genera Glareola, Stiltia, Rhinoptilus, Cursorius)
nštw|CHARADRIIFORM 2|oystercatcher (genus Haematopus)|avocet (genus Recurvirostra)|stilt (genera Cladorhynchus, Himantopus)
nšty|CHIONIDIFORM|stone-curlew, thick-knee (genera Burhinus, Esacus)|sheathbill/paddy (genus Chionis)|Magellanic plover (genus Pluvianellus)
ňsbl|FURNARIID (NEOTROPICAL OVENBIRD) 1|neotropical ovenbird, hornero, reedhaunter, rushbird, streamcreeper, earthcreeper, barbtail, tuftedcheeks (Furnariini)|treerunner, xenops, earthcreeper, palmcreeper (Pygarrhichnini plus Xenops and Berlepschia)|foliage-gleaner, hookbill, treehunter, great xenops (Philydorini)
ňsbr|FURNARIID (NEOTROPICAL OVENBIRD) 2|spintail, treerunner, rayadito, wiretail, tit-spinetail, thornbird, firweoodgatherer, brushrunner, cacholote, false canastero, wren-spinetail, prickletail, plushcrown, graveteiro, softtail, barbtail, reedhaunter (Synallaxini)|leaftosser, miner (genera Sclerurus, Geositta)|woodcreeper (Dendrocolaptines)
ňsbř|CISTICOLID (AFRICAN/ASIAN WARBLER) 2|prinia (genera Prinia, Schistolais, Phragmacia)|apalis (genera Apalis, Oreolais)|tailorbird (genus Orthotomus)
ňsbv|OTIDIMORPH (CUCKOO/BUSTARD)|cuckoo, koel, malkoha, coua, yellowbill, roadrunner, coucal, ani (Cuculid)|turaco, go-away-bird, plantain-eater (Musophagid)|bustard, florican, korhaan (Otidid)
ňsbw|FORMICAROID BIRD 1|crescentchest (genus Malanopareia)|antbird, antshrike, antwren, antvireo (Thamnophilid)|gnateater, antpitta (genera Conopophaga, Pittasoma)
ňsby|FORMICAROID BIRD 2|antpitta (Grallariid)|tapaculo, huet-huet, turca, gallito, bamboowren, bristlefront (Rhynocryptid)|antthrush (genera Formicarius, Chamaeza)
ňsdl|ACCIPITRIID 2|kite (Milvine, Elanine)|honey buzzard, kite (Pernine)|harpy eagle, crested eagle (genera Harpia, Morphnus, Harpyopsis)
ňsdr|ACCIPITRIID 3|hawk, buzzard, buzzard-eagle (Buteonine)|hawk, goshawk, sparrowhawk (Acciptrine, Melieraxine)|harrier, harrier-hawk (genera Circus, Polyboroides)
ňsdv|CAPRIMULGIFORM (NIGHTJAR/NIGHTHAWK) 1|nightjar, poorwill, whip-poor-will, pauraque (Caprimulgine, Eurostopodine)|nighthawk (genera Nyctiprogne, Chordeiles, Lurocalis)|owlet-nightjar (genus Aegotheles)
ňsdw|ACCIPITRIFORM/OPISTHOCOMID|osprey (genus Pandion)|secretarybird (genus Sagittarius)|hoatzin (genus Opisthocomus)
ňsdy|ACCIPITRIID 1|eagle, hawk-eagle (Aquiline)|sea eagle, ern, fish eagle, bald eagle (genus Haliaeetus)|snake-eagle, serpent-eagle, bateleur (Circaetine)
ňsgl|TYRANNIOID BIRD 1|manakin, tyrant-manakin, piprites (Piprid)|cotinga, plantcutter, berryeater, fruiteater, cock-of-the-rock, bellbird, piha, fruitcrow, capuchinbird, umbrellabird (Cotingid)|sharpbill, flycatcher, mylobius, tityra, schiffornis, mourner, purpletuft, laniisoma, xenopsaris, becard (Tityrid)
ňsgr|TYRANNIOID BIRD 2|flycatcher, tyrant, tyrannulet, kiskadee (Tyrannid)|spadebill (genus Platyrinchus)|flatbill (genera Rhynchocyclus, Tolmomyias, Ramphotrigon)
ňsgř|CISTICOLID (AFRICAN/ASIAN WARBLER) 4|camaroptera (genus Camaroptera)|eremomela (genus Eremomela)|n/a
ňsgv|CAPRIMULGIFORM (NIGHTJAR/NIGHTHAWK) 2|frogmouth (genera Podgarus, Batrachostomus, Rigidipenna)|potoo (genus Nyctibius)|oilbird (genus Steatornis)
ňsgw|SAPAYOID/ACANTHISITTID BIRD|sapayoa (genus Sapayoa)|rifleman (genus Acanthisitta)|New Zealand rock wren (genus Xenicus)
ňsgy|EURYLAIMOID BIRD|broadbill (Eurylaimid, Calyptomenid)|pitta (genera Pitta, Hydrornis, Erythropitta)|asity, sunbird-asity (genera Philepitta, Neodrepanis)
ňskç|PLATYSTEIRID|wattle-eye (genus Platysteira)|batis (genus Batis)|white-tailed shrike (genus Lanioturdus)
ňskf|VANGID 1|vanga (genera Vanga, Calicalicus, Schetba, Xenopirostris, Falculea, Artamella, Leptopterus, Cyanolanius, Oriolia, Tylas, Hypositta)|newtonia (genus Newtonia)|woodshrike (genus Tephrodornis)
ňskl|VIREONID 1|vireo (genus Vireo)|shrike-vireo (genus Vireolanius)|greenlet (genera Hylophilus, Tunchiornis, Pachysylvia)
ňskm|MALACONOTOID BIRD 1|boatbill (genus Machaerirhynchus)|mottled berryhunter/whistler (genus Rhagologus)|iora (genus Aegithina)
ňskn|MALACONOTOID BIRD 2|bristled shrike/bald-headed wood-shrike/Bornean bristlehead (genus Pityriasis)|bush-shrike, boubou, gonolek (genera Malaconotus, Laniarius, Telophorus, Chlorophoneus, Rhodophoneus)|brubru, puffback, tchagra (genera Nilaus, Dryoscopus, Bocagia, Tchagra)
ňskr|VIREONID 2|peppershrike (genus Cyclarhis)|shrike-babbler (genus Pteruthius)|white-bellied epornis (genus Epornis)
ňskř|ARTAMID|woodswallow (genus Artamus)|peltops (genus Peltops)|butcherbird, currawong, Australian magpie (genera Melloria, Cracticus, Strepara, Gymnorhina)
ňskv|VANGID 2|helmetshrike (genus Prionops)|philentoma (genus Philentoma)|flycatcher, flycatcher-shrike, shrike-flycatcher, Crossley’s babbler (genera Bias, Pseudobias, Hemipus, Megabyas, Mystacornis)
ňskw|ORIOLOID BIRD 1|whistler, strike-thrush (Pachycephalid)|Australo-Papuan bellbird (Oreocid)|crested shriketit (genus Falcunculus)
ňsky|ORIOLOID BIRD 2|whipbird, wedgebill (genera Psophodes, Androphobus)|painted berrypicker (genera Paramythia, Oreocharis)|wattled ploughbill (genus Eulacestoma)
ňspç|STRIGOPOID (NEW ZEALAND PARROT)|kaka (genus Nestor)|kea (Nestor notabilis)|kakapo (genus Strigops)
ňspf|PSITTACOID (PARROT)|parrot, parakeet, macaw, amazon, rosella, bluebonnet, racket-tail (Psittacoid)|lory, lorikeet (Loriine)|budgerigar/budgie (genus Melopsittacus)
ňspl|CORACIIFORM 1|roller, dollarbird (genera Coracias, Eurystomus)|ground roller (Brachypteraciid)|bee-eater (genera Merops, Meropogon, Nyctyornis)
ňspr|CORACIIFORM 2|kingfisher, kookaburra (Alcedinid)|tody (genus Todus)|motmot (Momotid)
ňspř|FALCONIFORM/CARIAMIFORM|falcon, falconet, kestrel, hobby, gyrfalcon (Falconine)|caracara (Polyborine)|seriema (genera Cariama, Chunga)
ňspv[f]|CACATUID (COCKATOO)|cockatoo, corella, galah (Cacatuine)|black cockatoo (genus Calyptorhynchus)|cockatiel/weiro/quarrion (genus Nymphicus)
ňspw|PICIFORM 1|honeyguide, honeybird (Indicatorid)|barbet, toucan-barbet (Megalaimid, Lybiid, Captonid, Semnornithid)|toucan, toucanet, araçari (Ramphastid)
ňspy|PICIFORM 2|jacamar (Galbulid)|puffbird (genera Notharchus, Bucco, Nystalus, Hypnelus, Malacoptila, Chelidoptera)|nunbird, nunlet, monklet (genera Monasa, Hapaloptila, Nonnula, Micromonacha)
ňstç|ACANTHIZID (AUSTRALIAN WARBLER) 4|pilotbird (genus Pyncoptilus)|redthroat, speckled warbler (genus Pyrrholaemus)|rockwarbler, mouse-warbler (genus Origma)
ňstf|CORVIFORM BIRD|quail-thrush, jewel-babbler (Cinclosomatid)|cuckooshrike, triller, minivet (Neosittid)|sitella (Neosittid)
ňstl|ACANTHIZID (AUSTRALIAN WARBLER) 1|scrubwren (genera Sericornis, Aethomyias, Neosericornis)|fernwren (genus Orescopus)|fieldwren, heathwren (genera, Hylacola, Calamanthus)
ňstm|MELIPHAGOID BIRD|bristlebird (genus Dasyornis)|pardalote/peep-wren (genus Pardalotes)|honeyeater, myzomela, chat, friarbird, kikau, straightbill, wattlebird, melidectes, myza (Meliphagid)
ňstn|ORTHOYCHOID BIRD|logrunner (Genus Orthonyx)|chowchilla (Orthonyx spaldingii)|Australasian babbler/pseudo-babbler (genus Pomatostomus)
ňstr|ACANTHIZID (AUSTRALIAN WARBLER) 2|thornbill (genus Acanthiza)|whiteface (genus Aphelocephala)|goldenface (genus Pachycare)
ňstř|ACANTHIZID (AUSTRALIAN WARBLER) 3|gerygone (genus Gerygone)|scrubtit (genus Acanthornis)|weebill (genus Smicornis)
ňstv|MOHOUID|whitehead (Mohoua albicilla)|pipipi/brown creeper (Mohoua novaeseelandiae)|yellowhead (Mohoua ochrocephala)
ňstw|CLIMACTERIOID BIRD|bowerbird (genera Archboldia, Amblyomis, Prionodura, Sericulus, Ptilonorhynchus, Chlamydera)|catbird (genera Ailuroedus, Scenopoeetes)|Australian treecreeper (genera Climacteris, Cormobates)
ňsty|MALURID (AUSTRALIAN WREN)|fairywren (Malurini)|emu-wren (genus Stipiturus)|grasswren (genus Amytornis)
ňštç|ICTERID 1|New World blackbird (genera Agelaius, Xanthspar, Agelasticus, Chrysomus, Nesopsar, Xanthocephalus, Dives, Euphagus, Gymnomystax, Amblyramphus, Curaeus, Anumara, Gnorimopsar, Oreopsar)|grackle (genera Quiscalus, Hypopyrrhus, Lampropsar, Macroagelaius)|New World oriole, troupial (genus Icterus)
ňštf|ICTERID 2|cowbird, baywing (genera Molothrus, Agelaioides)|meadowlark (genus Sturnella, Leistes)|marshbird (genus Pseudoleistes)
ňštl|PASSERIFORM BIRD 2|sunbird, spiderhunter (Nectariniid)|Przewalski’s finch/pinktail (genus Urocynchramus)|fairy-bluebird (genus Irena)
ňštr|PASSERIFORM BIRD 3|leafbird (genus Chloropsis)|olive warbler (genus Peucedramus)|accentor, dunnock, hedge sparrow (genus Prunella)
ňštř|PASSAROID BIRD|Old World sparrow, rockfinch, snowfinch, bush sparrow, ibon (Passerid)|wagtail, longclaw, pipit, shorttail, madanga (Motacillid)|longspur, bunting (genera Calcarius, Plectrophenax, Rhynchophanes)
ňštv|ICTERID 3|oropendola (genus Psarocolius)|cacique (genera Cacicus, Cassiculus, Amblycercus)|bobolink (genus Dolichonyx)
ňštw|ESTRILDOID BIRD|weaver, bishop, widowbird, fody, quelea, malimbe (Ploceid)|indigobird, whydah, cuckoo-finch (genera Vidua, Anomalospiza)|waxbill, mannikin, munia, silverbill, twinspot, firefinch, quailfinch, antpecker, nigrita, oliveback, pytilia, crimsonwing, seedcracker, bluebill, cordon-bleu, purple grenadier, avadavat, estrildid finch (Estrildid)
ňšty|PASSERIFORM BIRD 1|sugarbird (genus Promerops)|spot-throat, dapple-throat, grey-chested babbler (genera Modulatrix, Arcanator, Kakamega)|flowerpecker (genera Dicaeum, Prionochilus)
ňzdl|POLONIUM|polonium|Po ion w/missing electron(s)|Po ion w/additional electron(s)
ňzdr|LIVERMORIUM|livermorium|Lv ion w/missing electron(s)|Lv ion w/additional electron(s)
ňzdw|SELENIUM|selenium|Se ion w/missing electron(s)|Se ion w/additional electron(s)
ňzdy|TELLURIUM|tellurium|Te ion w/missing electron(s)|Te ion w/additional electron(s)
pçkf|FRANCIUM|francium|Fr ion w/missing electron(s)|Fr ion w/additional electron(s)
pçkl|POTASSIUM|potassium|K ion w/missing electron(s)|K ion w/additional electron(s)
pçkr|RUBIDIUM|rubidium|Rb ion w/missing electron(s)|Rb ion w/additional electron(s)
pçkř|CAESIUM|caesium|Cs ion w/missing electron(s)|Cs ion w/additional electron(s)
pçkw|LITHIUM|lithium|Li ion w/missing electron(s)|Li ion w/additional electron(s)
pçky|SODIUM|sodium|Na ion w/missing electron(s)|Na ion w/additional electron(s)
psbl|CARPET SHARK 1|nurse shark, blind shark (Ginglymostomatid, Brachaelurid)|wobbbegong shark (Orectobid)|bamboo shark (Hemiscylliid; genera Chyloscyllium, Hemiscyllium)
psbr|CARPET SHARK 2|whale shark (genus Rhincodon)|zebra shark (genus Stegostoma)|collared carpet shark (genera Cirrhoscyllium, Parascyllium)
psbř|CATSHARK|catshark (Scyliorhinid)|finback catshark, ribbontail, harlequin, graceful, or magnificent catshark (Proscylliid)|false catshark, gollumshark (Pseudotriakid; genera Pseudotriakis, Planonasus, Gollum)
psbv|PLATYCEPHALOID (FLATHEAD) FISH|flathead, deep-water flathead, ghost/armoured flathead (Platycephalid, Bembrid, Parabembrid, Hoplichthyid)|crocodilefish (genus Papilloculiceps)|armored searobin/gurnard (Peristediid)
psbw|LAMNIFORM SHARK 1|thresher shark (genus Alopius)|basking shark (genus Cetorhinus) |megamouth shark (genus Megachasma)
psby|LAMNIFORM SHARK 2|goblin shark (genus Mitsukurina)|sand shark, sand tiger shark, grey nurse shark, ragged tooth shark (Odontaspidid; genera Charcharias, Odontaspis)|crocodile shark (genus Pseudocarcharias)
pscw|TRACHICHTHYFORM FISH 1|roughy, slimehead, redfish, sawbelly (Trachichthyid)|sandpaper fish (genus Paratrychichthys)|pineapplefish / pinecone fish (genera Cleidopus, Monocentris)
psčw|TRACHICHTHYFORM FISH 2|fangtooth (genus Anoplogaster)|spinyfin (genera Diretmus, Diretmoides, Diretmichthys)|lanternfish/flashlight fish, eyelight fish (Anomalopid)
psdl|SQUALIFORM SHARK 2|lantern shark  (Etmopterid)|gulper shark (genera Centrophorus, Deania)|rough shark (genus Oxynotus)
psdr|SQUATINOFORM SHARK|angel shark (genus Squatinus)|sawshark (genera Pliotrema, Pristiophorus)|bramble shark, prickly shark (genus Echinorhinus)
psdř|GROUND SHARK|requiem shark (Carcharhinid)|weasel shark (Hemigaleid)|hammerhead shark, winghead shark, bonnethead, scoophead (genera Eusphyra, Sphyrna)
psdv|CHIMAERA|chimaera, rabbitfish, ghostshark, ratfish (genera Chimaera, Hydrolagus)|ploughnose chimaera, Cape elephantfish, Australian ghost shark (genus Callorhinchus)|spookfish, sicklefin chimaera, paddle-nose chimaera, longnose chimaera (Rhinochimaerid; genera Harriotta, Neoharriotta, Rhinochimaera)
psdw|COW SHARK/FRILLED SHARK|sevengill cow shark (Hexanchid; genera Heptranchias, Notorhynchus)|sixgill cow shark (genus Hexanchus)|frilled shark (genus Chlamydoselachus)
psdy|SQUALIFORM SHARK 1|dogfish shark (genera Cirrhigaleus, Squalus)|kitefin shark (Dalatiid)|sleeper shark (Somniosid)
psgḍ|ELECTRIC RAY|electric ray (genera Torpedo, Tetronarce)|numbfish, coffin ray (Narcinene, Hypnine)|sleeper ray (Narkine)
psgl|LAMPREY|pouched lamprey (genus Geotria)|Southern topeyed lamprey (genus Mordacia)|Northern lamprey (Petromyzontid)
psgr|SKATE (FISH)|skate (Rajid and Gurgesiellid)|smooth skate/leg skate (Anacanthobatid)|softnose skate (Arhynchobatid)
psgř|SAWFISH|largetooth, common, wide, freshwater, river, or northern sawfish/carpenter shark (P. pristis)|knifetooth, pointed, Queensland, green, longcomb, narrowsnout, or olive sawfish (Indo-Pacific species; Anoxypristis cuspidata, Pristis clavata, P. zijsron)|smalltooth sawfish (Atlantic species; Pristis pectinata)
psgv|STING RAY|stingray; cownose, eagle, manta, devil, butterfly, river, whiptail, deepwater, or sixgill ray (Myliobatoid)|panray (genus Zanobatis)|thornback (genera Platyrhina, Platyrhinoidis)
psgw|HAGFISH/LANCELET|hagfish (genera Rubicundus, Eptatretus, Myxine, Nemamyxine, Neomyxine, Notomyxine)|lancelet (Ampioxiform)|n/a
psgy|TUNICATE|sea squirt (Phlebobranchian, Aplousobranchian)|salp, pyrosome, doliolid tunicate (Thaliacean)|unusual tunicate (Stolidobranchian, Larvacean)
pskç|PERCOPSIFORM FISH|trout-perch (genus Percopsis)|pirate-perch (genus Aphredotus)|cavefish, swampfish, ricefish (Amblyopsid)
pskf|ZEIFORM FISH 1|dory (genera Zeus, Zenopsis) dory|lookdown, king, or silver dory (genus Cyttus)|zeniontid, capro dory (genera Zenion, Capromimus, Cyttomimus)
pskh|ZOARCOID FISH 1|wolffish/sea wolf, wolf eel (genera Anarhichas, Anarrhyichthys)|ronquil/ronchil, searcher (genera Bathymaster, Rathbunella, Ronquilus)|eelpout, pout, fish doctor (Zoarcid)
pskl|OSMERIFORM FISH|smelt, Australian-New Zealand grayling (Retropnnid, Osmerid)|ayu/sweetfish (genus Plecoglossus)|noodlefish/icefish (Salangid)
pskļ|ZOARCOID FISH 2|wrymouth (genus Cryptacanthodes)|graveldiver (genus Scytalina)|quillfish (genus Ptilichthys)
pskr|STERNOPTYCHID FISH|bottlelight, pearlside (Maurolicine)|constellationfish (genus Valenciennellus)|marine hatchetfish (Sternoptychine; genera Argyropelecus, Polyipnus, Sternoptyx)
pskř|STOMIIFORM FISH|bristlemouth, anglemouth, fangjaw (Gonostomatid)|barbeled dragonfish, loosejaw, stareater, snaggletooth, viperfish (Stomiid)|lightfish (Phosichthyid)
pskţ|ZOARCOID FISH 3|gunnel (Pholid)|prickleback/shanny (Stichaeid)|prowfish (Zaprorid)
pskv|ZEIFORM FISH 2|oreo (Oreosomatid)|parazen|tinselfish (Grammicolepidid)
pskw|SALMONID FISH|hucho, taimen/huchen, lenok (Eurasian Salmonid; genera Hucho, Parahucho, Brachymystax)|whitefish (genera Coregonus, Prosopium, Stenodus)|grayling (genus Thymallus)
psky|ESOCIFORM FISH|pike, pickerel (genus Esox)|muskellunge (Esox masquinongy)|mudminnow (Umbrid)
pspç|MORID FISH|common mora, googly-eyed cod (genus Mora)|ahuru (genus Auchenoceros)|codling, hakeling, mora, beardie, skulpin, grenadier cod (Morid)
pspf|PARACANTHOPTERYGIAN FISH|rattail/grenadier (Macrourid)|pelagic cod, arrowtail (Melanonid)|tube-eye/thread-tail (Stylephorid)
psph|MERLUCCIID FISH|hake (Merlucciid)|blue grenadier (genus Maruronus)|phycid hake (genera Phycis, Urophycis)
pspl|LOTID FISH 1|burbot/bubbot/lingcod/mariah/eelpout/coneyfish (genus Lota)|cusk/brismak/brosmius/torsk/moonfish (genus Brosme)|ling (genus Molva)
pspr|LOTID FISH 2|rockling (genus Gaidropsaurus)|fourbeard rockling (genus Enchelyopus)|ciliata fish
pspř|GADIFORM FISH|codlet (genus Bregmaceros)|eucla cod (genus Euclichthys)|eel cod (genera Muraenolepis, Notomuraenobathys)
pspţ|GASTEROSTEOID FISH|stickleback (Gasterosteid)|tube-snout (genus Aulorhynchus)|sand-eel, tubenose, sandlance (genera Hypoptychus, Aulichthys)
pspw|GADID FISH 2|tomcod (genus Microgadus)|blue whiting (genus Micromesistius)|pollock (genus Pollachius)
pspy|GADID FISH 3|arctic/polar cod (genera Arctogadus, Boreogadus)|unusual cod (genus Eleginus, Trisopterus)|tadpole fish (genus Raniceps)
pssc|TETRADONTIFORM FISH 1|puffer, pufferfish, blowfish, globefish, balloonfish, blowie, bubble fish, swellfish, toadfish, toady, honey toad, sugar toad, sea squab, toby, blaasop (Tetradontid, Triodontid)|porcupine fish/blowfish, burrfish, swelltoad (Diodontid)|spikefish, trumpetsnout (Triacanthodid)
pssč|TETRADONTIFORM FISH 2|triggerfish, picasso fish (Balistid)|triplespine/tripodfish (Triacanthid)|filefish, foolfish, shingle, leatherjacket, scraper (Monacanthid)
pssk|CICHLIFORM FISH|convict or engineer blenny/globy (genus Pholidichthys)|tilapia (Coelotilapine, Coptodonine, Heterotilapine, Oreochromine, Pelmatolapiine, Tilapiine)|cichlid
pssp|BLENNIOID FISH 1|blenny, rockskipper, combtooth blenny (Blenniid, Labrisomid)|pike-blenny, tube-blenny, flagblenny (Chaenopsid)|sand stargazer (Dactyloscopid)
psst|SCORPAENIFORM FISH 1|scorpionfish, rock fish, red rock cod (Scorpaenid)|paperfish/leaf scorpionfish (genus Taenionotus)|false scorpionfish (genus Centrogenys)
pstç|LEUCISCINE FISH 4|hardhead (genus Mylopharadon)|Sacramento blackfish (genus Orthodon)|peamouth (genus Mylocheilus)
pstf|LEUCISCINE FISH 5|sunbleak, belica, moderlieschen (genus Leucaspius)|sabre carp, sabrefish, ziege, sichel (genus Pelecus)|vimba (genus Vimba)
psth|CATFISH I|catfish (Silurid)|armored catfish, pencil catfish, parasitic catfish (Loricaroid)|velvet catfish (Diplomystoid)
pstl|LEUCISCINE FISH 1|minnow (small Leuciscine)|shiner (genera Condoma, Coreoleucisccus, Cyprinella, Luxilus, Lythrurus, Notemigonus, Notropis, Pteronotropis)|roach, pigo, kutum, other roach-like fish (genera Hesperoleucus, Rutilus, Samarutilus, Leucos)
pstļ|LEUCISCINE FISH 6|chub (genera Hybopsis, Semotilus, Squalius, Hemitremia, Platygobio, Nocomis, Couesius, Iotichthys, Snyderichthys, Oregonichthys, Petroleuciscus, Erimystax, Gila, Siphateles, Algansea)|rudd (genus Scardinius)|unusual leuciscine fish
pstr|LEUCISCINE FISH 2|bream (genera Abramis, Ballerus, Blicca)|dace (genera Chrosomus, Clinostomus, Leuciscus, Margariscus, Leucalburnus, Telestes)|nase, sneep (genera Chondrostoma, Protochondrostoma, Pseudochondrostoma)
pstř|LEUCISCINE FISH 3|tench, doctor fish (genus Tica)|stoneroller (genus Campostoma)|chiselmouth (genus Acrocheilus)
pstw|GONORYNCHID FISH|milkfish (genus Chanos)|beaked salmon/beaked sandfish (genus Gonorynchus)|shellear, hingemouth/snake mudhead (Knerioid)
psty|CYPRININE/ALEPOCEPHALID FISH|goldfish (Carassius auratus)|carp, Crucian carp, Prussian carp, kimbuna (Cyprinine other than Carassius)|smooth-head, slick-head marine smelt (Alepocephalid)
pščw|HOLOCENTRIFORM/POLYMIXIIFORM FISH|squirrelfish (genera Holocentrus, Neomiphon, Sargocentron)|soldierfish (Myripristine)|beardfish (genus Polymixia)
pškç|PLEURONECTID FISH (RIGHTEYE FLOUNDER) 7|curlfin sole, C-O sole, ridge-eyed flounder, ocellated turbot, spotted turbot, horny-head turbot (genus Pleuronichthys)|yellowfin sole, Sakhalin sole, yellowfin sole, common dab, longhead dab, yellowtail flounder, speckled flounder (genus Limanda)|diamond turbot (genus Hypsopsetta)
pškf|PLEURONECTID FISH (RIGHTEYE FLOUNDER) 8|stone flounder (genus Kereius)|Arctic flunder, Far Eastern smooth flounder (genus Liopsetta)|European flounder, starry flounder, Baltic flounder (genus Platichthys)
pškh|PLEURONECTID FISH (RIGHTEYE FLOUNDER) 9|winter, yellow-striped, cresthead, or marbled flounder (genus Pseudopleuronectes)|willowy flounder (genus Tenakius)|barfin flounder, spotted halibut (genus Verasper)
pškl|PLEURONECTID FISH (RIGHTEYE FLOUNDER) 4|deepsea sole (genus Embassichthys)|Pacific sand sole (genus Psettichthys)|slender sole (genus Lyopsetta)
pškļ|NOTOTHENIOID FISH 2|congoli/tupong, catadromous icefish (Pseudaphritid)|Patagonian blenny/Falkland’s mullet (Eleginopsid)|thornfish, bull blenny (Bovichtid)
pškr|PLEURONECTID FISH (RIGHTEYE FLOUNDER) 5|rocksole, dusky sole, Northern rock sole (genus Lepidopsetta)|butter sole (genus Isopsetta)|roughscale sole (genus Clidoderma)
pškř|PLEURONECTID FISH (RIGHTEYE FLOUNDER) 6|rex sole (Glyptocephalus zachirus)|witch flounder (Glyptocephalus cynoglossus)|blackfin flounder (Glyptocephalus stelleri)
pškţ|PLEURONECTID FISH (RIGHTEYE FLOUNDER) 10|peppered/measles flounder (genus Paralichthodes)|Kamchatka flounder, arrowtooth flounder (genus Atheresthes)|unusual righteye flounder (genera Cleisthenes, Dexistes)
pškw|PLEURONECTID FISH (RIGHTEYE FLOUNDER) 2|American plaice, flathead flounder, flathead sole, Bering flounder (genus Hippoglossoides)|European plaice, Alaska plaice, American smooth flounder (genus Pleuronectes)|scale-eye plaice (genus Acanthopsetta)
pšky|PLEURONECTID FISH (RIGHTEYE FLOUNDER) 3|lemon sole, Pacific Dover sole, slime flounder (genus Microstomus)|petrale sole, shotted halibut (genus Eopsetta)|English sole (genus Parophrys)
pšpç|PRIACANTHIFORM/CAPROIFORM FISH|bigeye, bulleye, bullseye, catalufa, glasseye (Priacanthid)|bandfish (Cepolid)|boarfish (genera Capros, Antigonia)
pšpf|SPARIFORM FISH|sea bream, porgy, picarel, musselcracker, pinfish, oblade, scup, salema, goldline (Sparid)|whiptail bream, false snapper, thread-fin bream, monocle bream, whiptail (Nemipterid)|big-eye, pigface, large-eye, or emperor bream, emperor (Lethrinid)
pšph|SERRANID FISH (SEA BASS/GROUPER)|sea bass, wirrah, koester, seaperch, splitfin, swallowtail, jewelfish, harlequin fish, perchlet, anthias, basslet, goldie, hamlet, comber (Anthiadine, Liopropomatine, Serranine)|grouper, coral grouper, lyretail, hind, mutton hamlet (Epinepheline)|soapfish, podge, skunkfish (Grammistine)
pšpl|ACANTHUROID FISH 1|surgeonfish, sawtail, doctorfish (genera Acanthuris, Ctenochaetus, Prionurus, Paracanthurus)|unicorn fish (genus Naso)|tang (genus Zebrasoma)
pšpļ|NOTOTHENIOID FISH 3|spiny plunderfish/plunderfish (Harpagiferid)|barbeled plunderfish (Artedidraconid)|n/a
pšpr|ACANTHUROID FISH 2|rabbitfish/spinefoot (genus Siganus)|scat fish (genera Scatophagus, Selenotoca)|louvar/luvar (genus Luvaris)
pšpř|ACANTHUROID FISH 3|spadefish, batfish (Ephippid)|sicklefish, concertina fish (genus Drepane)|Moorish idol (genus Zanclus)
pšpw|LUTJANIFORM FISH|snapper, jobfish, wenchman, pinjalo, beeliner, Chinamanfish (Lutjanid)|grunt, sargo, porkfish, margate, porgy, bonnetmouth, boga, dara, grunter, piggy, salema, sweetlips, rubberlip, slatey, thicklip, hotlips (Haemuline, Plectorhynchine)|fusilier, banana fish (Caesionid)
pšpy|LOBOTIFORM FISH|tigerfish, tiger perch, freshwater tripletail (genus Datnioides)|tripletail (genus Lobotes)|barbeled grunter, velvetchin, javelinfish (genus Hapalogenys)
pššč|TETRADONTIFORM FISH 3|sunfish/mola (genera Mola, Mastrurus, Ranzania)|boxfish, cowfish, trunkfish, turretfish, basketfish (Ostraciid, Aracanid)|n/a
pštç|SOLEID FISH 6|whiteblotched, small-head, banded-eye, or snakeskin sole (genus Soleichthys)|Kaup’s, Guinean, Commerson’s, Portuguese, white-margined, or saltpan sole (genus Synaptura)|African solonette (genus Vanstraelenia)
pštf|SCOPHTALMID FISH (TURBOT/BRILL)|turbot, brill, Black Sea turbot, windowpane flounder (genus Scophthalmus)|megrim/whiff (genus Lepidorhombus)|topknot (genera Phrynorhombus, Zeugopterus)
pšth|PLEURONECTIFORM FISH|spiny turbot, spottail spiny turbot, Indian halibut (genus Psettodes)|tonguefish (Cynoglossid)|n/a
pštl|SOLEID FISH 3|Cape, hook-nosed, bamboo, or true sole (genus Heteromycteris)|Allen’s, Bensbach River, Darwin, Kikori River, tailed, Lorentz River, manyscale, Robert’s, or three-line sole (genus Leptachirus)|bastard, Lusitanian, Frechkop’s, foureyed, thickback, or banded sole (genus Microchirus)
pštļ|NOTOTHENIOID FISH 1|cod icefish/notothen, icedevil, toothfish, notie, rockcod, Antarctic silverfish, southern cod, scalyhead (Nototheniid)|Antarctic dragonfish, ploughfish (Bathydraconid)|crocodile icefish/white-blooded fish, icefish (Channichthyid)
pštr|SOLEID FISH 4|whiskered sole (genus Monochirus)|piebald, peacock, southern peacock, finless, Persian carpet, or estuary sole (genus Pardachirus)|Cadenat’s, Adriatic, sand, blackhand, or Cyclope sole (genus Pegusa)
pštř|SOLEID FISH 5|banded, thickray, wavyband, zebra, or unicorn sole, (genera Aesopia, Pseudoaesopia, Zebria)|poisonous sole (genus Aseraggodes)|west coast sole, mud sole (genus Austroglossus)
pštw|SOLEID FISH 1|common sole (Solea solea)|Egyptian, elongated, ovate, Senegalese, or Stanaland’s sole (genus Solea)|unusual true sole (genera Achiroides, Barnardichthys, Bathysolea, Brachirus, Dagetichthys, Liachirus, Paradicula, Phyllichthys, Rendahlia, Rhinosolea, Synapturichthys, Synclidopus, Typhlachirus)
pšty|SOLEID FISH 2|yellow sole/solonette (genus Buglossidium)|tufted sole (genus Dexillus)|wedge sole (genus Dicologlossa)
rḍgr|THICK ARCH SHAPE
rftr|RIGHT TRIANGLE
rnsk|MUSCICAPOID BIRD 1|wren (Troglodytid)|treecreeper, spotted creeper (genera Certhia, Salpornis)|gnatcatcher, gnatwren (genera Polioptila, Microbates, Ramphocaenus)
rpļļ|JEST/PRANK/JOKE|(to be/make) a joke|(to be/make) a jest|(to be/pull) a prank
rpsk|PSEUDOCHROMID FISH (DOTTYBACK)|eel-blenny (Congrogadine)|dottyback (Pseudochromine, Anisochromine)|dottyback (Pseudoplesiopine)
rpsp|CENTRARCHID FISH 1|sunfish (genus Lepomis)|black bass (genus Micropterus)|crappie (genus Pomoxis)
rpst|CHARACIFORM FISH|distichodontid fish|lutefish (genera Citharidium, Citharinops, Citharinus)|South American darter, sailfin tetra (Crenuchid)
rpšk|MISC. PERCOMORPHARIAN FISH 1|mojarra Gerreid)|butterflyfish, coralfish bannerfish, pennantfish, talma, barberfish (Chaetodontid)|ponyfish, slipmouth, toothpony, slimy (Leiognathid)
rtļw|DIAMOND SHAPE
rtļy|RHOMBOID/PARALLELOGRAM
rtňw|NIOBIUM|niobium|Nb ion w/missing electron(s)|Nb ion w/additional electron(s)
rsňw|DUBNIUM|dubnium|Db ion w/missing electron(s)|Db ion w/additional electron(s)
řccw|THULIUM|thulium|Tm ion w/missing electron(s)|Tm ion w/additional electron(s)
řcčw|LUTETIUM|lutetium|Lu ion w/missing electron(s)|Lu ion w/additional electron(s)
řcpç|NEODYMIUM|neodymium|Nd ion w/missing electron(s)|Nd ion w/additional electron(s)
řcpf|SAMARIUM|samarium|Sm ion w/missing electron(s)|Sm ion w/additional electron(s)
řcpl|PROMETHIUM|promethium|Pm ion w/missing electron(s)|Pm ion w/additional electron(s)
řcpļ|EUROPIUM|europium|Eu ion w/missing electron(s)|Eu ion w/additional electron(s)
řcpr|TERBIUM|terbium|Tb ion w/missing electron(s)|Tb ion w/additional electron(s)
řcpř|GADOLINIUM|gadolinium|Gd ion w/missing electron(s)|Gd ion w/additional electron(s)
řcps|DYSPROSIUM|dysprosium|Dy ion w/missing electron(s)|Dy ion w/additional electron(s)
řcpš|HOLMIUM|holmium|Ho ion w/missing electron(s)|Ho ion w/additional electron(s)
řcpw|CERIUM|cerium|Ce ion w/missing electron(s)|Ce ion w/additional electron(s)
řcpy|PRASEODYMIUM|praseodymium|Pr ion w/missing electron(s)|Pr ion w/additional electron(s)
řpst|ACTINIUM|actinium|Ac ion w/missing electron(s)|Ac ion w/additional electron(s)
řpsc|BURKELIUM|berkelium|Bk ion w/missing electron(s)|Bk ion w/additional electron(s)
řpsč|CALIFORNIUM|californium|Cf ion w/missing electron(s)|Cf ion w/additional electron(s)
řpss|MENDELEVIUM|mendelevium|Md ion w/missing electron(s)|Md ion w/additional electron(s)
tļnw|TECHNETIUM|technetium|Tc ion w/missing electron(s)|Tc ion w/additional electron(s)
tļňw|BOHRIUM|bohrium|Bh ion w/missing electron(s)|Bh ion w/additional electron(s)
ţpss|CHITON/NAUTILUS/SCAPHOPOD|(chambered) nautilus (genera Allonautilus, Nautilus)|chiton/sea cradle (Polyplacophoran)|tusk shell/tooth shell (Scaphopod)
ţpšš|UNUSUAL MOLLUSC|solenogaster (Solenogastre/Neomeniomorph)|caudofoveate (Caudofoveata/Chaetodermomorpha)|monoplacophoran
lpskç[g]|PARALYCHTHYID FISH (LARGE-TOOTH FLOUNDER) 3|fine, Cortez, gulf, Brasilian, California, summer, Patagonian, broad, tropical, speckled, or olive flounder, fluke, bastard halibut, (genus Paralichthys)|ringed, peacock, largetooth, cinnamon, four twin-spot, ocellated, deep, Javan, smalltoothed, Malayan, roughscale, fivespot, five-eyed, spiny, or three spotted flounder (genus Pseudorhombus)|Papillose, shoal, beach, longfin, clearspot, channel, oval, or dusky flounder (genus Syacium)
lpskf|PARALYCHTHYID FISH (LARGE-TOOTH FLOUNDER) 4|Chinese brill (genus Tephrinectes)|fantail flounder (genus Xystreurys)|unusual large-tooth flounder (genera Cephalopsetta, Tarphops, Thysanopsetta)
lpskh|CITHARID FISH (LARGESCALE FLOUNDER)|yellow-dabbled flounder (genus Brachypleura)|scale-eyed flounder (genus Lepidoblepharon)|branched ray, twospot largescale, or spotted flounder (genera Citharus, Citharoides)
lpskl|BOTHID FISH (LEFTEYE FLOUNDER) 4|crested flounder (genus Lophonectes)|striped-fin flounder (genus Perissias)|unusual lefteye flounder (genera Asterorhombus, Chascanopsetta, Japonolaeops, Neolaeops, Parabothus, Psettina, Taeniopsetta, Tosarhombus, Tricopsetta)
lpskļ|POECILOPSETTINE FISH (BIGEYE FLOUNDER)|comb flounder (genus Marleyella)|large-scale, narrow-body, or small-mouth righteye flounder (genus Nematops)|colored, African, tile-colored, or Alcock’s narrow-body righteye flounder, deepwater dab (genus Poecilopsetta)
lpskr|PARALYCHTHYID FISH (LARGE-TOOTH FLOUNDER) 1|Cyclope, three-spot, three-eye, four-eyed, or Gulf of Mexico ocellated flounder (genus Ancylopsetta)|megrim/whiff, sanddab (genus Citharichthys)|Mexican, spotfin, toothed, or God’s flounder (genus Cyclopsetta)
lpskř|PARALYCHTHYID FISH (LARGE-TOOTH FLOUNDER) 2|fringed, shelf, smallmouth, Peruvian, gray, sole, or Delsman’s flounder (genus Etropus)|shrimp flounder (genus Gastropsetta)|bigmouth, fourspot, or American fourspot flounder (genus Hippoglossina)
lpskţ|SAMARID FISH (CRESTED FLOUNDER)|crested flounder, cockattoo righteye flounder, large-scale crested righteye flounder (genus Samaris, Samaretta)|coralline-red flounder, longfinned flounder, Huysman’s, deep-body, Luzon, large-mouth, spotted, New Caledonian, Nielsen’s, Sunier’s, or three-spot righteye flounder (genus Samariscus)|tongue flatfish (genus Plagiopsetta)
lpskw|BOTHID FISH (LEFTEYE FLOUNDER) 2|speckled-tail flounder, American spiny flounder (genus Engyophrys)|Krempf’s, Pennant, or threespot flounder (genus Grammatobothus)|fringelip dwar, Bellona, Bleeker’s, Largescale, Hureau’s, long pectoral fin, olive wide-eyed, Natal, long snout, or seven pelvic ray flounder, Regan’s flatfish (genus Engyprosopon)
lpsky|BOTHID FISH (LEFTEYE FLOUNDER) 3|wide-mouthed flounder (genus Kamoharaia)|clear fin-base, Philippine slender, Günther’s, khaki, blackspotted, small headed, or Longarm flounder (genus Laeops)|slim, Asaedae, Acapulco, deepwater, or Pacific deepwater flounder, Merten’s moonflounder, smalltooth moonflounder (genus Monolene)
lpspç|CARANGID FISH 7|fringefin trevally/round-finned trevally/reef herring (genus Pantolebus)|black pomfret (genus Parastromateus)|white trevally, skipjack trevally (genus Pseudocaranx)
lpspf|CARANGID FISH 8|oxeye scad, bigeye scad (genus Selar)|yellowstripe scad/yellowstripe trevally/yellow-banded trevally/smoothtailed trevally/slender-scaled trevally (genus Selaroides)|lookdown, moonfish (genus Selene)
lpsph|CARANGID FISH 9|saurel/jack mackerel (genus Trachurus)|silvermouth trevally, longrakered trevally (genus Ulua)|whitetongue jack, cottonmouth jack, whitemouth jack (genus Uraspis)
lpspl|CARANGID FISH 4|threadfish, diamond trevally (genus Alectis)|scad (genus Alepes)|cleftbelly trevally (genus Atropus)
lpspļ|CARANGIFORM FISH 1|roosterfish (genus Nematistius)|dolphinfish (genus Coryphaena)|cobia/black kingish/black bonito/lemonfish (genus Rachycentron)
lpspţ|CARANGIFORM FISH 3|threadfin, bobo, barbu, paradise fish (Polynemid)|beachsalmon (genus Leptobrama)|archerfish (genus Toxotes)
lpspr|CARANGID FISH 5|jack, trevally, bludger (genera Caranx, Carangoides, Hemicaranx)|yellowtail scad (genus Atule)|bumper/bumperfish (genus Chloroscombrus)
lpspř|CARANGID FISH 6|round, roughear, Indian, redtail, Japanese, shortfin or mackerel scad, koheru (genus Decapterus)|golden trevally/golden kingfish/king trevally (genus Gnathodon)|torpedo, hardtail, finny, cordyla, or finletted mackerel scad (genus Megalespis)
lpspw|CARANGID FISH 2|leatherjacket (genera Oligoplites, Parona)|vadigo (genus Campogramma)|rainbow runner/rainbow yellowtail, Spanish jack/Hawaiian salmon (genus Elagatis)
lpspy|CARANGID FISH 3|pilot fish (genus Naucrates)|amberjack (genus Seriola)|black-banded trevally (genus Seriolina)
lpstç|PLESIOPID FISH (LONGFIN/ROUNDHEAD) 4|longfin, prettyfin (genus Plesiops)|Christmas longfin, Steene’s prettyfin (genus Steeneichthys)|hulafish (genus Trachinops)
lpstl|PLESIOPID FISH (LONGFIN/ROUNDHEAD) 1|rockfish (genus Acanthoclinus)|spiny basslet, scottie, longfin (genus Acanthoplesiops)|Batan longfin, Southern longfin (genus Beliops)
lpstr|PLESIOPID FISH (LONGFIN/ROUNDHEAD) 2|barred spiny basslet (genus Belonepterygion)|shark-tailed eel-blenny, spotted eelblenny (genus Notograptus)|yellow, blue, or Randall’s devilfish (genus Assessor)
lpstř|PLESIOPID FISH (LONGFIN/ROUNDHEAD) 3|comet/marine betta (genus Calloplesiops)|carp prettyfin (genus Fraudella)|blue devil fish (genus Paraplesiops)
lpstw|AMBASSID FISH|glassy, perchlet, glass(y) perchlet, glassfish (genera Ambassis, Parambassis, Gymnochanda, Paradoxodacna, Pseudoambassis, Chanda)|four-spined glass perchlet (genus Tetracentrum)|pennyfish (genus Denariusa)
lpsty|MUGILID/EMBIOTOCID/GRAMMATID FISH|grey mullet (Mugilid)|surfperch/seaperch (Embiotocid)|basslet (genera Gramma, Lipogramma)
lpššt|SYNGNATHIFORM FISH 1|seahorse (genus Hippocampus)|pipefish, pipehorse, seadragon (Syngnathine)|ghost pipefish (genus Solenostomus)
lpštç|GOBIOID FISH 4|loach-goby (genera Protogobius, Rhyacichthys)|infantfish (genus Schindleria)| wriggler/collared wriggler, flathead wriggler (Xenisthmid)
lpštf|SCOMBRID FISH|tuna (Thunnine)|mackerel, Spanish mackerel, butterfly kingfish (Scombrine, Scoberomorine, Gasterochismatine)|bonito (Sardini; genera Sarda, Cybiosarda, Gymnosarda)
lpšth|TRICHIURID FISH (CUTLASSFISH)|scabbardfish (genera Aphanopus, Assurger, Evoxymetopon, Lepidopus)|frostfish (genus Benthodesmus)|hairtail (genera Eupleurogrammus, Demissolinea, Lepturacanthus, Tentoriceps, Thrichiurus)
lpštl|GOBIOID FISH 1|goby (Gobiine, Benthophiline, Gobionelline, Sicydiine)|eel/worm goby (Amblyopine)|mudskipper (Oxucerdid)
lpštļ|SYNBRANCHIFORM FISH|swamp eel (Synbranchid)|earthworm eel (Chaudhuriid)|spiny eel, fire eel (Mastacembelid)
lpštr|GOBIOID FISH 2|dartfish (Ptereleotrine)|sand darter (genera Kraemeria, Gobitrichinotus)|wormfish (Microdesmine)
lpštř|GOBIOID FISH 3|gudgeon (genera Thalasseleotris, Grahamichthys)|sleeper goby/sleeper (Eleotrid, Butid, Odontobutid)|blind cave goby (Milyeringid)
lpštw|KURTIFORM/BATRACHOIDID FISH|nurseryfish (genus Kurtus)|cardinalfish (Apogonid)|toadfish/frogfish (Batrachoidid)
lpšty|GEMPYLID FISH|snoek (genus Thyrsites, Tyrsitoides)|escolar (genera Tongaichthys, Rexichthys, Promethichthys, Lepidocybium, Diplospinus)|snake mackerel, domine, oilfish, sackfish, black gemfish (genera Epinnula, Gempylus, Nealotus, Neoepinnula, Nesiarchus, Paradiplospinus, Rexea, Ruvettus, Thyrsitops)
pssbl|LOPHIIFORM FISH (ANGLERFISH) 3|batfish, seabat (Ogcocephalid)|footballfish (genus Himantolophus)|horned lantern fish/prickly seadevil (genus Centrophryne)
pssbr|LOPHIIFORM FISH (ANGLERFISH) 4|warty seadevil (genera Ceratias, Cryptopsaras)|double angler/doublespine seadevil (genera Diceratias, Bufoceratias)|toothed/spiny/netbeard seadevil (genus Neoceratias)
pssbř|LOPHIIFORM FISH (ANGLERFISH) 5|fanfin/hairy anglerfish/fanfin seadevil (genera Caulophryne, Robia)|black seadevil (genus Melanocetus)|wolftrap angler (genera Thaumatichthys, Lasiognathus)
pssbv|LOPHIIFORM FISH (ANGLERFISH) 6|dreamer, dreamarm, tyrant devil (Oneirodid)|whipnose/whipnose angler/whipnose seadevil (genera Gigantactis, Rhynchactis)|leftvent/bearded seadevil, netdevil (Linophrynid)
pssbw|LOPHIIFORM FISH (ANGLERFISH) 1|angler, goosefish, monkfish, sea-devil (Lophiid)|handfish/warty angler (Brachionichthyid)|sea toad/coffinfish, frogmouth (genera Chaunax, Chaunacops)
pssby|LOPHIIFORM FISH (ANGLERFISH) 2|frogfish (Antennariine, Lophichthyid)|anglerfish (Histiophrynine)|four-armed frogfish (genera Tetrabrachium, Dibrachichthys)
pssdl|COTTOID FISH (SCULPIN) 1|sculpin, bullhead, cabezon (Cottid)|Antarctic sculpin (Bathylutichthyid)|sea raven (Hemitripterid)
pssdr|COTTOID FISH (SCULPIN) 2|scaled sculpin (genus Icelus)|Baikal oilfish (genus Comephorus)|Baikal/bighead sculpin (Cottocomephorid)
pssdř|COTTOID FISH (SCULPIN) 3|deepwater bullhead sculpin (genera Ereunias, Marukawichthys)|blobfish, toadfish, flathead sculpin, tadpole sculpin, fathead sculpin (Psychrolutid)|grunt-fish/grunt sculpin (genus Rhamphocottus)
pssdv|COTTOID FISH (SCULPIN) 4|lumpsucker/lumpfish (Cyclopterid)|snailfish/sea snail (Liparid)|deep-water sculpin (Abyssocottid)
pssdw|HOUNDSHARK/BULLHEAD SHARK|houndshark, barbeled houndshark (Triakine; genera Musteles, Scylliogaleus, Triakis, Leptocharius)|whiskery shark, school shark, sailback houndshark, blacktip tope (Galeorhinine)|bullhead shark (genus Heterodontus)
pssdy|MACKEREL SHARK (LAMNID)|great white shark (genus Carcharodon)|mako (genus Isurus)|salmon shark, porbeagle (genus Lamna)
pssgḍ|OSTEOGLOSSOID FISH 2|knifefish, featherback (Notopterid)|aba aba/freshwater rat-tail (genus Gymnarchus)|elephant fish (Mormyrid)
pssgl|BOWFIN/GAR|bowfin (genus Amia)|alligator gar, Cuban gar, tropical gar (genus Atractosteus)|spotted gar, longnose gar, shortnose gar, Florida gar (genus Lepisosteus)
pssgr|EEL/HALOSAUR|eel, moray, conger (Anguilliform)|deepsea spiny eel (Notacanthid; genera Lipogenys, Notacanthus, Polyacanthonotus)|halosaur (genera Aldrovandia, Halosaurus, Halosaropsis)
pssgř|ELOPIFORM/ALBULIFORM FISH|ladyfish, skipjack, jack-rash, tenpounder (genus Elops)|tarpon (genus Megalops)|bonefish (genera Nemoossis, Pterothrissus, Albula)
pssgv|OSTEOGLOSSOID FISH 1|bonytongue, arowana (Arapaimid, Osteoglossid; genera Heterotis, Arapaima, Scleropages, Osteoglossum)|butterflyfish (genus Pantodon)|mooneye, goldeye (genus Hiodon)
pssgw|ARCHAIC FISH|coelacanth (genus Latimeria)|lungfish (Ceratodontid, Lepidosirenid)|reedfish, bichir (Polypterid; genera Erpetoichthys, Polypterus)
pssgy|STURGEON/PADDLEFISH|sturgeon (Acipenserid)|American paddlefish (genus Polyodon)|Chinese paddlefish (genus Psephurus)
psskç|ANABLEPID FISH|four-eyed fish (genus Anableps)|onesided livebearer (genus Jenynsia)|white-eye fish(genus Oxyzygonectes)
psskf|POECILIID FISH|lampeye (Procatopodine)|banded lampeye (genus Aplocheilichthys)|livebearer (Poeciliine)
psskh|ATHERINOPSID FISH (NEOTROPICAL SILVERSIDE)|topsmelt, topsmelt silverside (genus Atherinops)|jacksmelt, jack silverside (genus Atherinopsis)|grunion (genus Leuresthes)
psskl|BELONIFORM FISH 1|ricefish, medaka (Adrianichthyid)|needlefish, long tom (Belonid)|flying fish/cod (Exocoetid)
psskļ|ATHERINOFORM FISH|unusual neotropical silverside fish (Atherinopsid, Notocheirid; genera Odontesthes, Basilichthys, Colpichthys, Notocheirus)|menidiine silverside|Old World silverside (Atherinid)
psskr|BELONIFORM FISH 2|saury (genera Cololabis, Scomberesox)|halfbeak/spipefish, ballyhoo (Hemiramphid)|viviparous halfbeak (Zenarchopterid)
psskř|CYPRINODONTIFORM FISH|killifish, topminnow (Aplocheiloid, Profundulid, Fundulid, Valenciid)|pupfish (Cyprinodonid)|springfish, poolfish, goodeid, splitfin, characodon, skiffia (Goodeid)
psskţ|ATHERINOID FISH|surf sardine, surf sprite, flower of the wave (genus Iso)|priapium fish (Phallostethid)|pricklenose, bearded, or tusked silverside, McCulloch’s hardyhead (genera Atherion, Dentatherina)
psskw|AQUARIUM CICHLID FISH|angelfish (genus Pterophyllum)|convict/zebra cichlid (genus Archocentrus)|discus, pompadour fish (genus Symphysodon)
pssky|SPORT-FISHING CICHLID FISH|peacock bass (genus Cichla)|oscar, tiger oscar, velvet cichlid, marble cichlid (genus Astronotus)|Mayan cichlid/Mexican mojarra (genus Mayaheros)
psspç|LABRID FISH (WRASSE) 4|tubelip wrasse (genus Labrichthys)|yellowtail tubelip (genus Diproctacanthus)|blue groper (genus Achoerodus)
psspf|LABRIFORM FISH|cale, weed whiting (Odacid)|n/a|n/a
pssph|TRACHINIFORM FISH 1|weever/weeverfish (genera Trachinus, Echichthys)|sandburrower/burrower, sand diver (Creediid)|sand lance, sand eel, launce (Ammodytid)
psspl|LABRID FISH (WRASSE) 1|wrasse (genera Halichoeres and others)|hogfish (genera Bodianus, Lachnolaimus)|parrotfish (Scarine labrid)
psspļ|TRACHINIFORM FISH 2|snaketooth fish/swallower (Chiasmodontid)|crocodile toothfish, sabre-gill, gaper (genus Champsodon)|torrentfish (genus Cheimarrichthys)
psspr|LABRID FISH (WRASSE) 2|razorfish (genus Xyrichtys)|rainbow wrasse, coris (genus Coris)|tuskfish (genus Choerodon)
psspř|LABRID FISH (WRASSE) 3|tautog, blackfish (genus Tautoga)|bergall (genus Tautogolabrus)|cleaner wrasse (genus Labroides)
psspţ|TRACHINIFORM FISH 4|sandfish (genera Trichodon, Arctoscopus)|sand-diver (genus Trichonotus)|stargazer (Uranoscopid)
psspw|BLENNIOID FISH 2|klipfish, cline, weedfish, kelpfish, eel blenny (Clinid)|triplefin/threefin, triplefin blenny (Tripterygiid)|n/a
psspy|BLENNIMORPHIC FISH|jawfish (Opistognathid)|clingfish (Gobiesocid)|n/a
psstç|SCORPAENIFORM FISH 7|rockfish, rock perch, ocean perch, sea perch, thornyhead, sea ruffe, rockcod (Sebastid)|gurnard perch, gurnard scorpionfish (genera Neosebastes, Maxillicosta)|sea robin, gurnard, latchet, piper gurnard (Triglid)
psstf|SCORPAENIFORM FISH 8|stonefish, stinger, stingfish, ghoul, devilfish (Synanceid)|pigfish, horsefish, racehorse (Congiopodid, Perryenid)|Australian prowfish, red Indianfish (Pataecid)
pssth|SCORPAENIFORM FISH 9|cofish (Eschmeyerid)|stinger flathead (Plectrogenid)|deap-sea bristly scorpionfish (Setarchid)
psstl|SCORPAENIFORM FISH 4|cobbler/estuary cobbler (genus Gymnapistes)|bullrout/freshwater stonefish/kroki (genus Notesthes)|bearded roguefish (genus Tetraroge)
psstļ|SCORPAENIFORM FISH 10|velvetfish, red velvetfish (Aploactinid, Gnathanacanthid)|visitor (genus Adventor)|coral croucher, orbicular velvetfish (genus Caracanthus)
psstr|SCORPAENIFORM FISH 5|poacher, snailfish, starsnout, rockhead (Agonid, Bathyagonines, Bothragonine)|hooknose/pogge/armed bullhead (genus Agonus)|alligatorfish (Anoplagonine)
psstř|SCORPAENIFORM FISH 6|sablefish/butterfish/black cod/blue cod/bluefish/candlefish/coal cod/coalfish/beshow, skilfish (genera Anoplopoma, Erilepsis)|greenling, ling/buffalo cod (Hexagrammid)|mole sculpin (genus Normanichthys)
psstw|SCORPAENIFORM FISH 2|lionfish, firefish, turkey fish (genus Dendrochirus)|lionfish (genus Ebosia)|lionfish, zebrafish, firefish, turkeyfish/tastyfish/butterfly-cod (genus Pterois)
pssty|SCORPAENIFORM FISH 3|wasp scorpionfish, waspfish (Apistid, Tetrarogid)|fortescue (genus Centropogon)|goblinfish, leaf goblinfish (genera Glyptauchen, Neovespicula)
psthw|CATFISH II|shark catfish, African catfish, squeaker (Pangasiid, Mochokid, Claroteid)|eeltail, airbreathing, or naked catfish (Plotosid, Ictalurid, Clariid, Ailiid, Sisorid, Bagrid)|banjo catfish, thorny/talking catfish, driftwood catfish, three-barbeled catfish, bumblebee/dwarf marbled catfish, long-whiskered catfish (Doradoid, Pimelodoid)
pškhw|PEMPHERIFORM FISH 2|deepwater cardinalfish (Epigonid)|armorhead, boarfish (Pentacerotid)|pearl perch, jewfish (Glaucosomatid)
pšphw|PEMPHERIFORM FISH 3|oceanic basslet (Howellid)|deep-sea herring (genera Bathyclupea, Neobathyclupea)|wreckfish, giant sea bass, bass grouper (genera Polyprion, Stereolepis)
pšthw|PEMPHERIFORM FISH 1|sweeper, bullseye (genera Pempheris, Parapriacanthus)|slopefish (genus Symphysanodon)|banjofish (genus Banjos)
rnskf|ZOSTEROPIDS (WHITE-EYE)|white-eye, striped babbler, pygmy babbler|yuhina (genera Yuhina, Sterrhoptilus)|heleia (genus Heleia)
rnskl|MUSCICAPOID BIRD 4|waxwing (genus Bombycilla)|palmchat (genus Dulus)|grey hypocolus (genus Hypocolius)
rnskr|MUSCICAPOID BIRD 5|mockingbird, catbird, thrasher (Mimid)|starling, myna, Philippine creeper (Sturnid)|oxpecker (Buphagid)
rnskř|MUSCICAPID|Old World flycatcher, forest flycatcher, tit-flycatcher, silverbird (Muscicapini, Niltavines)|magpie-robin, shama, scrub robin/bush-chat (genera Copsychus, Cercotrichas)|sholakili (genus Sholicola)
rnskw|MUSCICAPOID BIRD 2|wallcreeper (genus Tichodroma)|nuthatch (genus Sitta)|kinglet/crest (genus Regulus)
rnsky|MUSCICAPOID BIRD 3|spotted elachura/spotted wren-babbler (genus Elachura)|silky-flycatcher, phainoptila, phainopepla (Ptiliogonatid)|dipper (genus Cinclus)
rpskç|MYCTOPHIFORM/ATELEOPOD FISH|lanternfish (Myctophid)|blackchin (Neoscopelid)|jellynose/tadpole fish (Ateleopodid)
rpskf|LAMPRIFORM FISH I|sailfin moonfish (genera Velifer, Metavelifer)|opah/moonfish/sunfish/kingfish (genus Lampris)|tapertail (genus Radiicephalus)
rpskh|LAMPRIFORM FISH II|crestfish (genera Lophotus, Eumecichthys)|ribbonfish (genera Desmodema, Trachipterus, Zu)|oarfish (genera Agrostichthys, Regalecus)
rpskl|AULOPIFORM FISH 1|grinner (genera Bathysauropsis, Bathysauroides)|greeneye (genera Chlorophthalmus, Parasudis)|tripod fish (Ipnopid)
rpskļ|POMACENTRID FISH|clownfish/anemonefish (genera Amphiprion, Premnas)|damselfish (Chromine, Lepidozygine)|dascyllus, humbug (genus Dascyllus)
rpskr|AULOPIFORM FISH 2|waryfish (Notosudid)|deepsea lizardfish (genus Bathysaurus)|telescopefish (genus Gigantura)
rpskř|SYNODONTOID FISH 1|lizardfish, Bombay duck/bummalo, sand-diving lizardfish (Synodontid, Pseudotrichonotus)|flagfin (Aulopid)|cucumberfish (genus Paraulopus)
rpskţ|POMACENTRINE FISH 2|scalyfin, New Zealand black angelfish (genus Parma)|gregory (genus Stegastes)|damselfish (genera Chrysiptera, Amblyglyphidodon, Neopomacentrus, Cheiloprion, Dischistodus, Hemiglyphidodon, Teixeirichthys, Similiparma, Pomachromis, Plectroglyphidodon, Nexilosus, Microspathodon, Mecaenichthys)
rpskw|ALEPISAUROID FISH 1|lancetfish (genus Alepisaurus)|daggertooth (genus Anotopterus)|hammerjaw (genus Omosudis)
rpsky|ALEPISAUROID FISH 2|sabertooth (Evermannellid)|barracudina (Paralepidid)|pearleye (Scopelarchid)
rpspl|CENTRARCHIFORM FISH 1|marblefish, sea carp, rock cale (Aplodactylid)|trumpeter, morwong/butterfish/fingerfin/jackassfish/sea carp/snapper/moki (Latrid, Cheilodactylid)|kelpfish, silver spot (Chironemid)
rpspr|CENTRARCHIFORM FISH 1|hawkfish (Cirrhitid)|galjoen (Dichistiid)|pygmy sunfish (Elassomatid)
rpspř|CENTRARCHIFORM FISH 3|old wife (genus Enoplosus)|nibbler, drummer, opaleye, parore, blackfish, stripey bream (genera Girella, Graus)|flagtail (genus Kuhlia)
rpspw|CENTRARCHID FISH 2|banded sunfish (genus Enneacanthus)|flier (genus Centrarchus)|Sacramento perch (genus Archoplites)
rpspy|CENTRARCHID FISH 3|rock, shadow, Roanoke, or Ozark bass (genus Ambloplites)|mud sunfish (genus Acantharchus)|n/a
rpstç|CYPRINOID FISH|sucker fish (Catastomid)|psylorhynchus|loach, algae-eater (Cobitoid, Gyrinocheilid)
rpsst|ERYTHINOID FISH 1|tarumania|trahira/tararira (Erythrinid; genera Erythrinus, Hoplerythrinus, Hoplias)|dogtooth characin, vampire/sabretooth tetra (Cynodontid)
rpsth|KNIFEFISH|banded knifefish (Gymnotoid)|sand knifefish, bluntnose/grass/leaf knifefish (Rhamphichthyoid)|glass, rattail, or ghost knifefish (Apteronotoid)
rpstl|CYPRINID FISH 1|bitterling (Acheilognathine)|bleak (Alburnine)|gudeon, steed (Gobionine)
rpstr|CYPRINID FISH 2|barb, barbel, snowtrout, Leptobarbus (Barbine, Leptobarbine)|mud carp, labeo, yellowfish (Labeonine)|sharpbelly (Cultrine)
rpstř|CYPRINID FISH 3|carplet, rasbora, flying barb, razorbelly minnow (Danionine)|grass carp, black carp, bighead carp (Squaliobarbine, Xenocyprine)|giant salmon carp, blind barb, mahseer, cavefish, catla, rohtee, unusual cyprinid fish (Psylorhynchid, unclassified Cyprinid)
rpstw|ALESTIOID FISH|African pike characin (genus Hepsetus)|African tetra (Alestiid)|n/a
rpsty|SERRASALMID FISH|piranha (genera Catoprion, Pristobrycon, Pygocentrus, Pygopristis, Serrasalmus)|pacu|silver dollar fish
rpškç|MISC. PERCOMORPHARIAN FISH 4|manefish (Caristiid)|leaffish (genera Monocirrhus, Polycentrus)|marine angelfish (Pomacanthid)
rpškf|MISC. PERCOMORPHARIAN FISH 5|ruff/Australian herring, Australian salmon, kahawai (genus Arripis)|tilefish, Quakerfish, blanquillo (Malacanthid)|combfish (genus Zaniolepis)
rpškh|MISC. PERCOMORPHARIAN FISH 6|long-finned/yellowfin pike (genus Dinolestes)|jutjaw (genus Parascorpis)|whiting, smelt-whiting, sand borer, sand-smelt, sillago (Sillaginid)
rpškl|RHOMBOSOLEID FISH (SOUTHERN HEMISPHERE RIGHTEYE FLOUNDER) 1|shortfin, elongate, Tudor’s, or longsnout flounder (genus Ammotretis)|banded-fin/spotted flounder (genus Azygopus)|Remo flounder (genus Oncopterus)
rpškļ|MISC. PERCOMORPHARIAN FISH 7|drum, croaker, sheephead, wuss fish, shepherd’s pie, gou, Gasper goo, grinder, meagre, kob, mulloway, weakfish, bahaba, corvina, spot, king fish, curbinata, pacora, drummer, red, queenfish, stardrum, totoaba/totuava (Sillaginid)|moony, mono/Malayan angel, moonyfish, fingerfish, pomfret (genera Monodactylus, Schuettea)|rover, redbait, rubyfish, kali kali (Emmelichthyid)
rpškr|RHOMBOSOLEID FISH (SOUTHERN HEMISPHERE RIGHTEYE FLOUNDER) 2|New Zealand brill/turbot (genus Colistium)|speckled/New Zealand sole (genus Peltorhamphus)|southern/New Zealand lemon sole (genus Pelotretis)
rpškř|RHOMBOSOLEID FISH (SOUTHERN HEMISPHERE RIGHTEYE FLOUNDER) 3|yellowbelly, sand, black, or greenback flounder (genus Rhombosolea)|Indonesian ocellated flounder (genus Psammodiscus)|Derwent flounder (genus Taratretis)
rpškţ|MISC. PERCOMORPHARIAN FISH 8|bluefish, tailor, elf (genus Pomatomus)|false trevally (genus Lactarius)|n/a
rpškw|MISC. PERCOMORPHARIAN FISH 2|Asian seabass (genus Lateolabrax)|cavebass, barred seabass, lampfish (genera Dinoperca, Centrarchopos)|splendid perch, groppo (genera Callantias, Grammatonotus)
rpšky|MISC. PERCOMORPHARIAN FISH 3|temperate bass, white perch (genera Morone, Dicentrarchus)|lanternbelly/temperate ocean bass, rosy seabass/blackthroat seaperch, seabass, splitfin (Acropomatid)|lates perch, spikey bass, Waigieu seaperch, Waigeo barramundi (Latid)
řpscw|EINSTEINIUM|einsteinium|Es ion w/missing electron(s)|Es ion w/additional electron(s)
řpsčw|FERMIUM|fermium|Fm ion w/missing electron(s)|Fm ion w/additional electron(s)
řpssw|NOBELIUM|nobelium|No ion w/missing electron(s)|No ion w/additional electron(s)
řpssy|LAWRENCIUM|lawrencium|Lr ion w/missing electron(s)|Lr ion w/additional electron(s)
řpstf|AMERICIUM|americium|Am ion w/missing electron(s)|Am ion w/additional electron(s)
řpstl|URANIUM|uranium|U ion w/missing electron(s)|U ion w/additional electron(s)
řpstļ|CURIUM|curium|Cm ion w/missing electron(s)|Cm ion w/additional electron(s)
řpstr|NEPTUNIUM|neptunium|Np ion w/missing electron(s)|Np ion w/additional electron(s)
řpstř|PLUTONIUM|plutonium|Pu ion w/missing electron(s)|Pu ion w/additional electron(s)
řpstw|THORIUM|thorium|Th ion w/missing electron(s)|Th ion w/additional electron(s)
řpsty|PROTACTINIUM|protactinium|Pa ion w/missing electron(s)|Pa ion w/additional electron(s)
lpskhw[h]|ACHIROPSETTID FISH (SOUTHERN FLOUNDER)|finless/prickly flounder, armless flounder (genera Achiropsetta, Neoarchiropsetta)|Antarctic armless flounder (genus Mancopsetta)|pygmy flounder (genus Pseudomancopsetta)
lpsphw|CARANGIFORM FISH 2|remora/suckerfish, lousefish (Echeneid)|moonfish (genus Mene)|snook (genus Centropomus)
lpšštç|SCOMBRIFORM FISH 4|barracuda (genus Sphyraena)|swordfish/broadbill (genus Xiphias)|marlin/billfish (Istiophorid)
lpšštf|SYNGNATHIFORM FISH 4|snipefish/bellowfish (genus Macroramphosus)|shrimpfish (genera Aeoliscus, Centriscus)|flying/helmet gurnard (genera Dactyloptena, Dactylopterus)
lpššth|ANABANTIFORM FISH|snakefish (Channid)|chameleonfish (genera Badis, Dario)|Asian leaffish (Nandid, Pristolepidid)
lpšštl|SCOMBRIFORM FISH 1|pomfret, fanfish (Bramid)|butterfish, silver pomfret, harvestfish, Pacific pompano (genera Pampus, Peprilus, Stromateus)|driftfish, fathead, cubehead, cigarfish, man-of-war, bluebottle, ariomma, ariommid (genera Cubiceps, Nomeus, Psenes, Ariomma)
lpšštr|SCOMBRIFORM FISH 2|longfin escolar/black mackerel (genus Scombrolabrax)|amarsipa (genus Amarsipus)|squaretail (genus Tetragonurus)
lpšštř|SCOMBRIFORM FISH 3|medusafish, ruff, rudderfish, blackfish, barrelfish, butterfish, warehou/trevalla (Centrolophid)|ragfish (genus Icosteus)|gnomefish (genus Scombrops)
lpšštw|SYNGNATHIFORM FISH 2|seamoth (genus Pegasus, Euypegasus)|trumpetfish (genus Aulostomus)|cornetfish/flutemouth (genus Fistularia)
lpššty|SYNGNATHIFORM FISH 3|goatfish/red mullet (Mullid)|dragonet (Callionymid)|slope dragonet (genera Draconetta, Centrodraco)
lpšthw|ANABANTOID FISH (GOURAMI)|gourami (Osphronemid)|kissing gourami, kisser (genus Helostoma)|climbing gourami/climbing perch (Anabantid)
pssphw|TRACHINIFORM FISH 3|southern sandfish, flathead pygmy-stargazer, estuary stargazer (genera Crapatalus, Leptoscopus, Lesueuina)|duckbill (Percophid)|sandperch, grubfish (Pinguipedid)
rpskhw|POMACENTRINE FISH 1|sergeant, sergeant-major, nightsergeant (genus Abudefduf)|garibaldi fish (genus Hypsypops)|demoiselle/lyretail damselfish (genus Neopomacentrus)
rpsstç|CENTRARCHIFORM FISH 5|knifejaw (Oplegnathid)|temperate perch, nightfish, pygmy perch, perchlet, mandarin fish, oriental perch (Percichtyid, Percalatid, Perciliid, Sinipercid)|grunter, tigerperch, terapon, trumpeter (Terapontid)
rpsstl|CHARACID FISH 1|characin fish, tetra|characin-like fish (Stevardiin, Characine)|unusual characin-like fish (Spintherobolid, Stethaprionine)
rpsstr|CHARACID FISH 2|pike-characin (Ctenoluciid; genera Boulengerella, Ctenolucius)|pencil fish, including valadora (Lebiasinid)|dorado (genus Salminus)
rpsstř|CENTRARCHIFORM FISH 6|sea chub (Kyphosine)|footballer, moonlighter (Kyphosine)|halfmoon, grey knifefish, blue knifefish, sweep (Scorpindine)
rpsstw|ERYTHINOID FISH 2|hemiodontid fish|pardontid fish|flannel-mouthed characin (Prochilodontid)
rpssty|ERYTHINOID FISH 3|headstander (Chilodontid; genera Caenotropus, Chilodus)|toothless characin (Curimatid)|anostomid fish
rpsthw|SALAMANDERFISH/SMELT/GALAXIA|salamanderfish (genus Lepidogalaxias)|smelt, barreleye (Argentinoid)|galaxia (Galaxiid)
  - Cr|basic description
  - Cr|basic description|IFL Stem 1|IFL Stem 2|Stem 3
